AAAAATCACGGTACCGTGCC -> AAAATCACGGTACCGTGCCG
AAAACGTCTTTTGACAACTT -> AAACGTCTTTTGACAACTTT
AAAAGCGTGGCCGGTAATTG -> AAAGCGTGGCCGGTAATTGT
AAAATCACGGTACCGTGCCG -> AAATCACGGTACCGTGCCGG
AAAATTTGCTGCAATCTTAA -> AAATTTGCTGCAATCTTAAA
AAACACCGTAAATATGCTAA -> AACACCGTAAATATGCTAAG
AAACATATCTTAGTGGACTA -> AACATATCTTAGTGGACTAA
AAACATTGGCGTCGCATAAC -> AACATTGGCGTCGCATAACA
AAACCTGACACAGACTCCGA -> AACCTGACACAGACTCCGAT
AAACGAAGAATCACATTGAC -> AACGAAGAATCACATTGACA
AAACGGTGTTCTCTGCAGTA -> AACGGTGTTCTCTGCAGTAA
AAACGTCTTTTGACAACTTT -> AACGTCTTTTGACAACTTTT
AAACTAAAAATCACGGTACC -> AACTAAAAATCACGGTACCG
AAACTAACGAATAATCGAGA -> AACTAACGAATAATCGAGAG
AAACTAAGAATATCACCCCG -> AACTAAGAATATCACCCCGG
AAACTAAGCCAAATTTATTT -> AACTAAGCCAAATTTATTTG
AAACTGACTTGTAGCCTAAG -> AACTGACTTGTAGCCTAAGG
AAAGACCTCGCGCCGAAGGA -> AAGACCTCGCGCCGAAGGAC
AAAGAGTTTAGTTGTGAAGT -> AAGAGTTTAGTTGTGAAGTC
AAAGCGTGGCCGGTAATTGT -> AAGCGTGGCCGGTAATTGTC
AAAGGGCATGCGTACGAGGT -> AAGGGCATGCGTACGAGGTG
AAATACAGGATAGAGGGCGC -> AATACAGGATAGAGGGCGCT
AAATATATTAATTCCCAACA -> AATATATTAATTCCCAACAC
AAATATGCTAAGCGATGACG -> AATATGCTAAGCGATGACGG
AAATCACGGTACCGTGCCGG -> AATCACGGTACCGTGCCGGT
AAATCACGTGAACCGGCTGA -> AATCACGTGAACCGGCTGAC
AAATCCGAAGAAGTTGTGAA -> AATCCGAAGAAGTTGTGAAG
AAATCTACTTATACACCAGC -> AATCTACTTATACACCAGCA
AAATGACATAACGTCCCAGC -> AATGACATAACGTCCCAGCC
AAATGCTATGCTGATTTTCA -> AATGCTATGCTGATTTTCAA
AAATTTATTTGATTCGGACC -> AATTTATTTGATTCGGACCC
AAATTTGCTGCAATCTTAAA -> AATTTGCTGCAATCTTAAAG
AACACCCTCGCGCGGGGAGG -> ACACCCTCGCGCGGGGAGGG
AACACCGTAAATATGCTAAG -> ACACCGTAAATATGCTAAGC
AACACTAGGGGAAATCACGT -> ACACTAGGGGAAATCACGTG
AACAGAGGCATTGATTATGT -> ACAGAGGCATTGATTATGTT
AACAGCGGGTGTCGCTACCG -> ACAGCGGGTGTCGCTACCGT
AACAGGAATTACTACGAGTG -> ACAGGAATTACTACGAGTGA
AACAGTAAAATTTGCTGCAA -> ACAGTAAAATTTGCTGCAAT
AACATACTATATCCGTGTAC -> ACATACTATATCCGTGTACA
AACATAGTGGAAGCTGCAAC -> ACATAGTGGAAGCTGCAACA
AACATATCTTAGTGGACTAA -> ACATATCTTAGTGGACTAAA
AACATTGGCGTCGCATAACA -> ACATTGGCGTCGCATAACAT
AACATTTGTCGACATGACAC -> ACATTTGTCGACATGACACC
AACCGCAAGGTGAAGAGGGA -> ACCGCAAGGTGAAGAGGGAT
AACCGCATGTTATTCTACTC -> ACCGCATGTTATTCTACTCT
AACCGGCTGACGACCGATAA -> ACCGGCTGACGACCGATAAG
AACCGGGTATATCTGTTGCG -> ACCGGGTATATCTGTTGCGA
AACCTAAGTCCCCGGGGTGA -> ACCTAAGTCCCCGGGGTGAA
AACCTAGAACTTTCCGTCGC -> ACCTAGAACTTTCCGTCGCT
AACCTGACACAGACTCCGAT -> ACCTGACACAGACTCCGATT
AACCTGATGGCATTTACCCC -> ACCTGATGGCATTTACCCCG
AACCTTGACTCCTTAGGCAT -> ACCTTGACTCCTTAGGCATC
AACGAAGAATCACATTGACA -> ACGAAGAATCACATTGACAG
AACGAAGACTTGAATTACTA -> ACGAAGACTTGAATTACTAA
AACGAATAATCGAGAGTCAT -> ACGAATAATCGAGAGTCATC
AACGCAGGACTTGTCTGTTC -> ACGCAGGACTTGTCTGTTCA
AACGCTATTGCCTGTGCTTG -> ACGCTATTGCCTGTGCTTGT
AACGGGCTAAAACGTCTTTT -> ACGGGCTAAAACGTCTTTTG
AACGGTGTTCTCTGCAGTAA -> ACGGTGTTCTCTGCAGTAAT
AACGTCCCAGCCTCTTAATT -> ACGTCCCAGCCTCTTAATTT
AACGTCTTTTGACAACTTTT -> ACGTCTTTTGACAACTTTTC
AACTAAAAATCACGGTACCG -> ACTAAAAATCACGGTACCGT
AACTAACGAATAATCGAGAG -> ACTAACGAATAATCGAGAGT
AACTAAGAATATCACCCCGG -> ACTAAGAATATCACCCCGGC
AACTAAGCCAAATTTATTTG -> ACTAAGCCAAATTTATTTGA
AACTGACTTGTAGCCTAAGG -> ACTGACTTGTAGCCTAAGGA
AACTTACACACCGACTGGTT -> ACTTACACACCGACTGGTTA
AACTTTCCGTCGCTACTTAC -> ACTTTCCGTCGCTACTTACA
AACTTTTCCTATCACAGGGG -> ACTTTTCCTATCACAGGGGA
AAGAAGTTGTGAAGTCAAAC -> AGAAGTTGTGAAGTCAAACT
AAGAATATCACCCCGGCGTC -> AGAATATCACCCCGGCGTCA
AAGAATCACATTGACAGAGT -> AGAATCACATTGACAGAGTA
AAGACCTCGCGCCGAAGGAC -> AGACCTCGCGCCGAAGGACA
AAGACTTGAATTACTAATCC -> AGACTTGAATTACTAATCCA
AAGAGGCCCTTCTCAGCCTT -> AGAGGCCCTTCTCAGCCTTA
AAGAGGGATCGCCCTGACGC -> AGAGGGATCGCCCTGACGCG
AAGAGTTGCCGACGAAATGC -> AGAGTTGCCGACGAAATGCT
AAGAGTTTAGTTGTGAAGTC -> AGAGTTTAGTTGTGAAGTCA
AAGCAGGGGGTTGCGGATGC -> AGCAGGGGGTTGCGGATGCA
AAGCCAAATTTATTTGATTC -> AGCCAAATTTATTTGATTCG
AAGCGATGACGGATACATTA -> AGCGATGACGGATACATTAC
AAGCGTGGCCGGTAATTGTC -> AGCGTGGCCGGTAATTGTCG
AAGCTCCCACAGTACAGCGG -> AGCTCCCACAGTACAGCGGG
AAGCTGCAACATACTATATC -> AGCTGCAACATACTATATCC
AAGGACATGCGATACCATAA -> AGGACATGCGATACCATAAC
AAGGACCGTGAGTATGGTTA -> AGGACCGTGAGTATGGTTAA
AAGGAGGGTGCCCTACGGCT -> AGGAGGGTGCCCTACGGCTC
AAGGCAGCTACTCAAGTCAC -> AGGCAGCTACTCAAGTCACT
AAGGCTCGATAATGTCTACG -> AGGCTCGATAATGTCTACGA
AAGGGCATGCGTACGAGGTG -> AGGGCATGCGTACGAGGTGG
AAGGTGAAGAGGGATCGCCC -> AGGTGAAGAGGGATCGCCCT
AAGTAATGACTATTCTGACA -> AGTAATGACTATTCTGACAT
AAGTATGCCTATACTCTTTT -> AGTATGCCTATACTCTTTTA
AAGTCAAACTAAAAATCACG -> AGTCAAACTAAAAATCACGG
AAGTCAAACTAACGAATAAT -> AGTCAAACTAACGAATAATC
AAGTCAAACTAAGAATATCA -> AGTCAAACTAAGAATATCAC
AAGTCAAACTAAGCCAAATT -> AGTCAAACTAAGCCAAATTT
AAGTCACTTCCCATAACAGT -> AGTCACTTCCCATAACAGTA
AAGTCCCCGGGGTGAACAGC -> AGTCCCCGGGGTGAACAGCG
AAGTGATGTTCTTCCGCCCC -> AGTGATGTTCTTCCGCCCCG
AAGTTGTGAAGTCAAACTAA -> AGTTGTGAAGTCAAACTAAA,AGTTGTGAAGTCAAACTAAG,AGTTGTGAAGTCAAACTAAC
AATAATCGAGAGTCATCCTC -> ATAATCGAGAGTCATCCTCA
AATAATGCAACCTAGAACTT -> ATAATGCAACCTAGAACTTT
AATACAGGATAGAGGGCGCT -> ATACAGGATAGAGGGCGCTA
AATATAACGAAGACTTGAAT -> ATATAACGAAGACTTGAATT
AATATATTAATTCCCAACAC -> ATATATTAATTCCCAACACT
AATATCACCCCGGCGTCATC -> ATATCACCCCGGCGTCATCT
AATATGCTAAGCGATGACGG -> ATATGCTAAGCGATGACGGA
AATATTTTACTTCGCTTTCA -> ATATTTTACTTCGCTTTCAG
AATCACATTGACAGAGTAGC -> ATCACATTGACAGAGTAGCT
AATCACGGTACCGTGCCGGT -> ATCACGGTACCGTGCCGGTA
AATCACGTGAACCGGCTGAC -> ATCACGTGAACCGGCTGACG
AATCAGCGTTGTAACACCCT -> ATCAGCGTTGTAACACCCTC
AATCCATTTTATTCAACAGA -> ATCCATTTTATTCAACAGAG
AATCCGAAGAAGTTGTGAAG -> ATCCGAAGAAGTTGTGAAGT
AATCCGGACGCAAGAGTTGC -> ATCCGGACGCAAGAGTTGCC
AATCCTCGTCGCAGTGCGAT -> ATCCTCGTCGCAGTGCGATT
AATCGAGAGTCATCCTCAGT -> ATCGAGAGTCATCCTCAGTT
AATCTACATCGAACAGGAAT -> ATCTACATCGAACAGGAATT
AATCTACTTATACACCAGCA -> ATCTACTTATACACCAGCAC
AATCTTAAAGGGCATGCGTA -> ATCTTAAAGGGCATGCGTAC
AATCTTATCAGGGGTTCGCC -> ATCTTATCAGGGGTTCGCCT
AATCTTCGAATTCAACGCTA -> ATCTTCGAATTCAACGCTAT
AATGACATAACGTCCCAGCC -> ATGACATAACGTCCCAGCCT
AATGACTATTCTGACATCAC -> ATGACTATTCTGACATCACA
AATGAGAGTCGCCAGTCAGG -> ATGAGAGTCGCCAGTCAGGA
AATGCAACCTAGAACTTTCC -> ATGCAACCTAGAACTTTCCG
AATGCTATGCTGATTTTCAA -> ATGCTATGCTGATTTTCAAC
AATGTCTACGATCACGCGAG -> ATGTCTACGATCACGCGAGT
AATTAAACATATCTTAGTGG -> ATTAAACATATCTTAGTGGA
AATTACTAATCCATTTTATT -> ATTACTAATCCATTTTATTC
AATTACTACGAGTGAAGGCA -> ATTACTACGAGTGAAGGCAG
AATTCAACGCTATTGCCTGT -> ATTCAACGCTATTGCCTGTG
AATTCCCAACACTAGGGGAA -> ATTCCCAACACTAGGGGAAA
AATTGTCGGGCATGAGTGAA -> ATTGTCGGGCATGAGTGAAC
AATTTATTTGATTCGGACCC -> ATTTATTTGATTCGGACCCC
AATTTGCTGCAATCTTAAAG -> ATTTGCTGCAATCTTAAAGG
AATTTGTACATCGTGGCTCG -> ATTTGTACATCGTGGCTCGT
ACAAAAGCGTGGCCGGTAAT -> CAAAAGCGTGGCCGGTAATT
ACAAACCTGACACAGACTCC -> CAAACCTGACACAGACTCCG
ACAACTTTTCCTATCACAGG -> CAACTTTTCCTATCACAGGG
ACAAGCAGGGGGTTGCGGAT -> CAAGCAGGGGGTTGCGGATG
ACAAGTGATGTTCTTCCGCC -> CAAGTGATGTTCTTCCGCCC
ACAATATTTTACTTCGCTTT -> CAATATTTTACTTCGCTTTC
ACACACCGACTGGTTATTGT -> CACACCGACTGGTTATTGTT
ACACAGACTCCGATTCAATC -> CACAGACTCCGATTCAATCT
ACACCAGCACTAGGTGGAGC -> CACCAGCACTAGGTGGAGCG
ACACCCTCGCGCGGGGAGGG -> CACCCTCGCGCGGGGAGGGA
ACACCGAAATCCGAAGAAGT -> CACCGAAATCCGAAGAAGTT
ACACCGACTGGTTATTGTTA -> CACCGACTGGTTATTGTTAT
ACACCGCTCGACAGCCTAGT -> CACCGCTCGACAGCCTAGTT
ACACCGCTGCTTTTGTCGAC -> CACCGCTGCTTTTGTCGACA
ACACCGGCAAAGAGTTTAGT -> CACCGGCAAAGAGTTTAGTT
ACACCGTAAATATGCTAAGC -> CACCGTAAATATGCTAAGCG
ACACCGTTGCCGCCGTTAGT -> CACCGTTGCCGCCGTTAGTT
ACACGGGCGTAAGTAATGAC -> CACGGGCGTAAGTAATGACT
ACACGGTAGCAGACGGATCC -> CACGGTAGCAGACGGATCCA
ACACTAGGGGAAATCACGTG -> CACTAGGGGAAATCACGTGA
ACACTTCGAGCTGCCTACGT -> CACTTCGAGCTGCCTACGTT
ACAGACTCCGATTCAATCTA -> CAGACTCCGATTCAATCTAC
ACAGAGGCATTGATTATGTT -> CAGAGGCATTGATTATGTTT
ACAGAGTAGCTTTAAACGGT -> CAGAGTAGCTTTAAACGGTG
ACAGCCTAGTTGTGAAGTCA -> CAGCCTAGTTGTGAAGTCAA
ACAGCGGGGTCAGTTGCTGC -> CAGCGGGGTCAGTTGCTGCA
ACAGCGGGTGTCGCTACCGT -> CAGCGGGTGTCGCTACCGTA
ACAGCGGTGGACGTAATAAT -> CAGCGGTGGACGTAATAATG
ACAGGAATTACTACGAGTGA -> CAGGAATTACTACGAGTGAA
ACAGGATAGAGGGCGCTACA -> CAGGATAGAGGGCGCTACAA
ACAGGGGAATCCTCGTCGCA -> CAGGGGAATCCTCGTCGCAG
ACAGGTGGTAGCAACTTACA -> CAGGTGGTAGCAACTTACAC
ACAGTAAAATTTGCTGCAAT -> CAGTAAAATTTGCTGCAATC
ACAGTACAGCGGGGTCAGTT -> CAGTACAGCGGGGTCAGTTG
ACATAACGTCCCAGCCTCTT -> CATAACGTCCCAGCCTCTTA
ACATACTATATCCGTGTACA -> CATACTATATCCGTGTACAA
ACATAGTGGAAGCTGCAACA -> CATAGTGGAAGCTGCAACAT
ACATATCTTAGTGGACTAAA -> CATATCTTAGTGGACTAAAT
ACATCACACGGTAGCAGACG -> CATCACACGGTAGCAGACGG
ACATCGAACAGGAATTACTA -> CATCGAACAGGAATTACTAC
ACATCGTGGCTCGTCTTACC -> CATCGTGGCTCGTCTTACCA
ACATGACACCGAAATCCGAA -> CATGACACCGAAATCCGAAG
ACATGACACCGCTCGACAGC -> CATGACACCGCTCGACAGCC
ACATGACACCGGCAAAGAGT -> CATGACACCGGCAAAGAGTT
ACATGACACCGTTGCCGCCG -> CATGACACCGTTGCCGCCGT
ACATGAGCGACGCTTATCGG -> CATGAGCGACGCTTATCGGA
ACATGCGATACCATAACCTT -> CATGCGATACCATAACCTTG
ACATGTAAGGCTCGATAATG -> CATGTAAGGCTCGATAATGT
ACATTACATGTAAGGCTCGA -> CATTACATGTAAGGCTCGAT
ACATTCGCGCAGGGCCAGTG -> CATTCGCGCAGGGCCAGTGA
ACATTGACAGAGTAGCTTTA -> CATTGACAGAGTAGCTTTAA
ACATTGGCGTCGCATAACAT -> CATTGGCGTCGCATAACATT
ACATTTGTCGACATGACACC -> CATTTGTCGACATGACACCG
ACCAGCACTAGGTGGAGCGG -> CCAGCACTAGGTGGAGCGGT
ACCATAACCTTGACTCCTTA -> CCATAACCTTGACTCCTTAG
ACCATAGATGTTCGGTTGCC -> CCATAGATGTTCGGTTGCCA
ACCCCGAAATCTACTTATAC -> CCCCGAAATCTACTTATACA
ACCCCGGCGTCATCTAGCAG -> CCCCGGCGTCATCTAGCAGG
ACCCCTAGTTGTACAAGCAG -> CCCCTAGTTGTACAAGCAGG
ACCCTCCGCGCGTTCGCATA -> CCCTCCGCGCGTTCGCATAA
ACCCTCGCGCGGGGAGGGAT -> CCCTCGCGCGGGGAGGGATG
ACCGAAATCCGAAGAAGTTG -> CCGAAATCCGAAGAAGTTGT
ACCGACAAAAGCGTGGCCGG -> CCGACAAAAGCGTGGCCGGT
ACCGACTGGTTATTGTTATG -> CCGACTGGTTATTGTTATGC
ACCGATAAGCTCCCACAGTA -> CCGATAAGCTCCCACAGTAC
ACCGCAACGCAGGACTTGTC -> CCGCAACGCAGGACTTGTCT
ACCGCAAGGTGAAGAGGGAT -> CCGCAAGGTGAAGAGGGATC
ACCGCATGTTATTCTACTCT -> CCGCATGTTATTCTACTCTC
ACCGCCATAGCGACCTTTGT -> CCGCCATAGCGACCTTTGTC
ACCGCGCCTCTCGAGCGGGG -> CCGCGCCTCTCGAGCGGGGT
ACCGCTCGACAGCCTAGTTG -> CCGCTCGACAGCCTAGTTGT
ACCGCTGCTTTTGTCGACAT -> CCGCTGCTTTTGTCGACATG
ACCGGCAAAGAGTTTAGTTG -> CCGGCAAAGAGTTTAGTTGT
ACCGGCTGACGACCGATAAG -> CCGGCTGACGACCGATAAGC
ACCGGGTATATCTGTTGCGA -> CCGGGTATATCTGTTGCGAT
ACCGTAAATATGCTAAGCGA -> CCGTAAATATGCTAAGCGAT
ACCGTACCGTCTATTGCGCT -> CCGTACCGTCTATTGCGCTA
ACCGTGAGTATGGTTAATAT -> CCGTGAGTATGGTTAATATA
ACCGTGCCGGTACCTCCCTA -> CCGTGCCGGTACCTCCCTAG
ACCGTTGCCGCCGTTAGTTG -> CCGTTGCCGCCGTTAGTTGT
ACCTAAGTCCCCGGGGTGAA -> CCTAAGTCCCCGGGGTGAAC
ACCTAGAACTTTCCGTCGCT -> CCTAGAACTTTCCGTCGCTA
ACCTAGACGGCTTACCTGCT -> CCTAGACGGCTTACCTGCTT
ACCTCCCTAGCTATACGGGA -> CCTCCCTAGCTATACGGGAA
ACCTCGCGCCGAAGGACATG -> CCTCGCGCCGAAGGACATGC
ACCTGACACAGACTCCGATT -> CCTGACACAGACTCCGATTC
ACCTGATGGCATTTACCCCG -> CCTGATGGCATTTACCCCGA
ACCTGCTTGCGATGTGTATC -> CCTGCTTGCGATGTGTATCG
ACCTTGACTCCTTAGGCATC -> CCTTGACTCCTTAGGCATCA
ACCTTTGTCGACATGACACC -> CCTTTGTCGACATGACACCG
ACGAAATGCTATGCTGATTT -> CGAAATGCTATGCTGATTTT
ACGAAGAATCACATTGACAG -> CGAAGAATCACATTGACAGA
ACGAAGACTTGAATTACTAA -> CGAAGACTTGAATTACTAAT
ACGAATAATCGAGAGTCATC -> CGAATAATCGAGAGTCATCC
ACGACCGATAAGCTCCCACA -> CGACCGATAAGCTCCCACAG
ACGAGGTGGATGGCATCGTG -> CGAGGTGGATGGCATCGTGT
ACGAGTGAAGGCAGCTACTC -> CGAGTGAAGGCAGCTACTCA
ACGATCACGCGAGTAACCGG -> CGATCACGCGAGTAACCGGG
ACGCAAGAGTTGCCGACGAA -> CGCAAGAGTTGCCGACGAAA
ACGCAGGACTTGTCTGTTCA -> CGCAGGACTTGTCTGTTCAG
ACGCGAGTAACCGGGTATAT -> CGCGAGTAACCGGGTATATC
ACGCGATCTGGTCAAACGAA -> CGCGATCTGGTCAAACGAAG
ACGCGGCACGGTTTAACCGC -> CGCGGCACGGTTTAACCGCA
ACGCTATTGCCTGTGCTTGT -> CGCTATTGCCTGTGCTTGTT
ACGCTTATCGGAACATAGTG -> CGCTTATCGGAACATAGTGG
ACGGATACATTACATGTAAG -> CGGATACATTACATGTAAGG
ACGGATCCATCCCTTAGGCA -> CGGATCCATCCCTTAGGCAC
ACGGCTCCTAGCATATGTAC -> CGGCTCCTAGCATATGTACA
ACGGCTTACCTGCTTGCGAT -> CGGCTTACCTGCTTGCGATG
ACGGGAAAGACCTCGCGCCG -> CGGGAAAGACCTCGCGCCGA
ACGGGCGTAAGTAATGACTA -> CGGGCGTAAGTAATGACTAT
ACGGGCTAAAACGTCTTTTG -> CGGGCTAAAACGTCTTTTGA
ACGGTACCGTGCCGGTACCT -> CGGTACCGTGCCGGTACCTC
ACGGTAGCAGACGGATCCAT -> CGGTAGCAGACGGATCCATC
ACGGTGTTCTCTGCAGTAAT -> CGGTGTTCTCTGCAGTAATC
ACGGTTTAACCGCAAGGTGA -> CGGTTTAACCGCAAGGTGAA
ACGTAATAATGCAACCTAGA -> CGTAATAATGCAACCTAGAA
ACGTCCCAGCCTCTTAATTT -> CGTCCCAGCCTCTTAATTTG
ACGTCTTTTGACAACTTTTC -> CGTCTTTTGACAACTTTTCC
ACGTGAACCGGCTGACGACC -> CGTGAACCGGCTGACGACCG
ACGTTTGCACTATGAAACAT -> CGTTTGCACTATGAAACATT
ACTAAAAATCACGGTACCGT -> CTAAAAATCACGGTACCGTG
ACTAAATACAGGATAGAGGG -> CTAAATACAGGATAGAGGGC
ACTAACGAATAATCGAGAGT -> CTAACGAATAATCGAGAGTC
ACTAAGAATATCACCCCGGC -> CTAAGAATATCACCCCGGCG
ACTAAGCCAAATTTATTTGA -> CTAAGCCAAATTTATTTGAT
ACTAATCCATTTTATTCAAC -> CTAATCCATTTTATTCAACA
ACTACGAGTGAAGGCAGCTA -> CTACGAGTGAAGGCAGCTAC
ACTAGGGGAAATCACGTGAA -> CTAGGGGAAATCACGTGAAC
ACTAGGTGGAGCGGTGAGAA -> CTAGGTGGAGCGGTGAGAAC
ACTATATCCGTGTACAATAT -> CTATATCCGTGTACAATATT
ACTATGAAACATTGGCGTCG -> CTATGAAACATTGGCGTCGC
ACTATTCTGACATCACACGG -> CTATTCTGACATCACACGGT
ACTCAAGTCACTTCCCATAA -> CTCAAGTCACTTCCCATAAC
ACTCCGATTCAATCTACATC -> CTCCGATTCAATCTACATCG
ACTCCTCACACGGGCGTAAG -> CTCCTCACACGGGCGTAAGT
ACTCCTTAGGCATCAGTGTT -> CTCCTTAGGCATCAGTGTTA
ACTCGTGGGATACACTTCGA -> CTCGTGGGATACACTTCGAG
ACTCTCAAACACCGTAAATA -> CTCTCAAACACCGTAAATAT
ACTCTCATGGCTGCTACCGC -> CTCTCATGGCTGCTACCGCA
ACTCTTTTAATCTTCGAATT -> CTCTTTTAATCTTCGAATTC
ACTGACTTGTAGCCTAAGGA -> CTGACTTGTAGCCTAAGGAG
ACTGGTTATTGTTATGCCCG -> CTGGTTATTGTTATGCCCGC
ACTTACAAACCTGACACAGA -> CTTACAAACCTGACACAGAC
ACTTACACACCGACTGGTTA -> CTTACACACCGACTGGTTAT
ACTTATACACCAGCACTAGG -> CTTATACACCAGCACTAGGT
ACTTCCCATAACAGTAAAAT -> CTTCCCATAACAGTAAAATT
ACTTCGAGCTGCCTACGTTT -> CTTCGAGCTGCCTACGTTTG
ACTTCGCTTTCAGAGTGTTA -> CTTCGCTTTCAGAGTGTTAA
ACTTGAATTACTAATCCATT -> CTTGAATTACTAATCCATTT
ACTTGTAGCCTAAGGAGGGT -> CTTGTAGCCTAAGGAGGGTG
ACTTGTCTGTTCAGCCCACA -> CTTGTCTGTTCAGCCCACAT
ACTTTCCGTCGCTACTTACA -> CTTTCCGTCGCTACTTACAA
ACTTTTCCTATCACAGGGGA -> CTTTTCCTATCACAGGGGAA
AGAACCTAAGTCCCCGGGGT -> GAACCTAAGTCCCCGGGGTG
AGAACTTTCCGTCGCTACTT -> GAACTTTCCGTCGCTACTTA
AGAAGTTGTGAAGTCAAACT -> GAAGTTGTGAAGTCAAACTA
AGAATATCACCCCGGCGTCA -> GAATATCACCCCGGCGTCAT
AGAATCACATTGACAGAGTA -> GAATCACATTGACAGAGTAG
AGACCTCGCGCCGAAGGACA -> GACCTCGCGCCGAAGGACAT
AGACGGATCCATCCCTTAGG -> GACGGATCCATCCCTTAGGC
AGACGGCTTACCTGCTTGCG -> GACGGCTTACCTGCTTGCGA
AGACTCCGATTCAATCTACA -> GACTCCGATTCAATCTACAT
AGACTTGAATTACTAATCCA -> GACTTGAATTACTAATCCAT
AGAGGCATTGATTATGTTTC -> GAGGCATTGATTATGTTTCG
AGAGGCCCTTCTCAGCCTTA -> GAGGCCCTTCTCAGCCTTAT
AGAGGGATCGCCCTGACGCG -> GAGGGATCGCCCTGACGCGA
AGAGGGCGCTACAAGTGATG -> GAGGGCGCTACAAGTGATGT
AGAGTAGCTTTAAACGGTGT -> GAGTAGCTTTAAACGGTGTT
AGAGTCATCCTCAGTTTATA -> GAGTCATCCTCAGTTTATAC
AGAGTCGCCAGTCAGGAAAC -> GAGTCGCCAGTCAGGAAACT
AGAGTGTTAAGGACCGTGAG -> GAGTGTTAAGGACCGTGAGT
AGAGTTGCCGACGAAATGCT -> GAGTTGCCGACGAAATGCTA
AGAGTTTAGTTGTGAAGTCA -> GAGTTTAGTTGTGAAGTCAA
AGATGTTCGGTTGCCACAGG -> GATGTTCGGTTGCCACAGGT
AGCAACTTACACACCGACTG -> GCAACTTACACACCGACTGG
AGCACTAGGTGGAGCGGTGA -> GCACTAGGTGGAGCGGTGAG
AGCAGACGGATCCATCCCTT -> GCAGACGGATCCATCCCTTA
AGCAGGCATACCTAGACGGC -> GCAGGCATACCTAGACGGCT
AGCAGGGGGTTGCGGATGCA -> GCAGGGGGTTGCGGATGCAG
AGCATATGTACAGCGGTGGA -> GCATATGTACAGCGGTGGAC
AGCCAAATTTATTTGATTCG -> GCCAAATTTATTTGATTCGG
AGCCCACATGAGCGACGCTT -> GCCCACATGAGCGACGCTTA
AGCCTAAGGAGGGTGCCCTA -> GCCTAAGGAGGGTGCCCTAC
AGCCTAGTTGTGAAGTCAAA -> GCCTAGTTGTGAAGTCAAAC
AGCCTCTTAATTTGTACATC -> GCCTCTTAATTTGTACATCG
AGCCTTATCAGTCTCGAGTT -> GCCTTATCAGTCTCGAGTTA
AGCGACCTTTGTCGACATGA -> GCGACCTTTGTCGACATGAC
AGCGACGCTTATCGGAACAT -> GCGACGCTTATCGGAACATA
AGCGATGACGGATACATTAC -> GCGATGACGGATACATTACA
AGCGGGGTCAGTTGCTGCAT -> GCGGGGTCAGTTGCTGCATT
AGCGGGGTTGCAGGGCTGTT -> GCGGGGTTGCAGGGCTGTTT
AGCGGGTGTCGCTACCGTAC -> GCGGGTGTCGCTACCGTACC
AGCGGTGAGAACCTAAGTCC -> GCGGTGAGAACCTAAGTCCC
AGCGGTGGACGTAATAATGC -> GCGGTGGACGTAATAATGCA
AGCGTGGCCGGTAATTGTCG -> GCGTGGCCGGTAATTGTCGG
AGCGTTGTAACACCCTCGCG -> GCGTTGTAACACCCTCGCGC
AGCTACTCAAGTCACTTCCC -> GCTACTCAAGTCACTTCCCA
AGCTATACGGGAAAGACCTC -> GCTATACGGGAAAGACCTCG
AGCTCCCACAGTACAGCGGG -> GCTCCCACAGTACAGCGGGG
AGCTCGCATACCGCCATAGC -> GCTCGCATACCGCCATAGCG
AGCTGCAACATACTATATCC -> GCTGCAACATACTATATCCG
AGCTGCCTACGTTTGCACTA -> GCTGCCTACGTTTGCACTAT
AGCTTTAAACGGTGTTCTCT -> GCTTTAAACGGTGTTCTCTG
AGGAAACTGACTTGTAGCCT -> GGAAACTGACTTGTAGCCTA
AGGAATTACTACGAGTGAAG -> GGAATTACTACGAGTGAAGG
AGGACATGCGATACCATAAC -> GGACATGCGATACCATAACC
AGGACCGTGAGTATGGTTAA -> GGACCGTGAGTATGGTTAAT
AGGACTTGTCTGTTCAGCCC -> GGACTTGTCTGTTCAGCCCA
AGGAGGGTGCCCTACGGCTC -> GGAGGGTGCCCTACGGCTCC
AGGATAGAGGGCGCTACAAG -> GGATAGAGGGCGCTACAAGT
AGGCACCGCGCCTCTCGAGC -> GGCACCGCGCCTCTCGAGCG
AGGCAGCTACTCAAGTCACT -> GGCAGCTACTCAAGTCACTT
AGGCATACCTAGACGGCTTA -> GGCATACCTAGACGGCTTAC
AGGCATCAGTGTTATGGAGC -> GGCATCAGTGTTATGGAGCT
AGGCATTGATTATGTTTCGT -> GGCATTGATTATGTTTCGTA
AGGCCCTTCTCAGCCTTATC -> GGCCCTTCTCAGCCTTATCA
AGGCTCGATAATGTCTACGA -> GGCTCGATAATGTCTACGAT
AGGGATCGCCCTGACGCGAT -> GGGATCGCCCTGACGCGATC
AGGGATGGTTTTTACTCCTC -> GGGATGGTTTTTACTCCTCA
AGGGCATGCGTACGAGGTGG -> GGGCATGCGTACGAGGTGGA
AGGGCATGGAGGTTCCCGGA -> GGGCATGGAGGTTCCCGGAA
AGGGCCAGTGAACCTGATGG -> GGGCCAGTGAACCTGATGGC
AGGGCGCTACAAGTGATGTT -> GGGCGCTACAAGTGATGTTC
AGGGCTGTTTTACTCGTGGG -> GGGCTGTTTTACTCGTGGGA
AGGGGAAATCACGTGAACCG -> GGGGAAATCACGTGAACCGG
AGGGGAATCCTCGTCGCAGT -> GGGGAATCCTCGTCGCAGTG
AGGGGGTTGCGGATGCAGTA -> GGGGGTTGCGGATGCAGTAG
AGGGGTTCGCCTAATGAGAG -> GGGGTTCGCCTAATGAGAGT
AGGGTGCCCTACGGCTCCTA -> GGGTGCCCTACGGCTCCTAG
AGGTGAAGAGGGATCGCCCT -> GGTGAAGAGGGATCGCCCTG
AGGTGGAGCGGTGAGAACCT -> GGTGGAGCGGTGAGAACCTA
AGGTGGATGGCATCGTGTTC -> GGTGGATGGCATCGTGTTCC
AGGTGGTAGCAACTTACACA -> GGTGGTAGCAACTTACACAC
AGGTGGTGCGTTTTCGCTTG -> GGTGGTGCGTTTTCGCTTGA
AGGTTCCCGGAAATATATTA -> GGTTCCCGGAAATATATTAA
AGTAAAATTTGCTGCAATCT -> GTAAAATTTGCTGCAATCTT
AGTAACCGGGTATATCTGTT -> GTAACCGGGTATATCTGTTG
AGTAATCAGCGTTGTAACAC -> GTAATCAGCGTTGTAACACC
AGTAATGACTATTCTGACAT -> GTAATGACTATTCTGACATC
AGTACAGCGGGGTCAGTTGC -> GTACAGCGGGGTCAGTTGCT
AGTACTCTCATGGCTGCTAC -> GTACTCTCATGGCTGCTACC
AGTAGCTTTAAACGGTGTTC -> GTAGCTTTAAACGGTGTTCT
AGTAGGTGGTGCGTTTTCGC -> GTAGGTGGTGCGTTTTCGCT
AGTAGTACTCTCATGGCTGC -> GTAGTACTCTCATGGCTGCT
AGTATGCCTATACTCTTTTA -> GTATGCCTATACTCTTTTAA
AGTATGGTTAATATAACGAA -> GTATGGTTAATATAACGAAG
AGTCAAACTAAAAATCACGG -> GTCAAACTAAAAATCACGGT
AGTCAAACTAACGAATAATC -> GTCAAACTAACGAATAATCG
AGTCAAACTAAGAATATCAC -> GTCAAACTAAGAATATCACC
AGTCAAACTAAGCCAAATTT -> GTCAAACTAAGCCAAATTTA
AGTCACTTCCCATAACAGTA -> GTCACTTCCCATAACAGTAA
AGTCAGGAAACTGACTTGTA -> GTCAGGAAACTGACTTGTAG
AGTCATCCTCAGTTTATACG -> GTCATCCTCAGTTTATACGC
AGTCCCCGGGGTGAACAGCG -> GTCCCCGGGGTGAACAGCGG
AGTCGCCAGTCAGGAAACTG -> GTCGCCAGTCAGGAAACTGA
AGTCTCGAGTTACCGACAAA -> GTCTCGAGTTACCGACAAAA
AGTGAACCGCATGTTATTCT -> GTGAACCGCATGTTATTCTA
AGTGAACCTGATGGCATTTA -> GTGAACCTGATGGCATTTAC
AGTGAAGGCAGCTACTCAAG -> GTGAAGGCAGCTACTCAAGT
AGTGATCCGCAATCTTATCA -> GTGATCCGCAATCTTATCAG
AGTGATGTTCTTCCGCCCCG -> GTGATGTTCTTCCGCCCCGC
AGTGCGATTGCTTTAAATGA -> GTGCGATTGCTTTAAATGAC
AGTGGAAGCTGCAACATACT -> GTGGAAGCTGCAACATACTA
AGTGGACTAAATACAGGATA -> GTGGACTAAATACAGGATAG
AGTGTTAAGGACCGTGAGTA -> GTGTTAAGGACCGTGAGTAT
AGTGTTATGGAGCTCGCATA -> GTGTTATGGAGCTCGCATAC
AGTTACCGACAAAAGCGTGG -> GTTACCGACAAAAGCGTGGC
AGTTGACCCTCCGCGCGTTC -> GTTGACCCTCCGCGCGTTCG
AGTTGCCGACGAAATGCTAT -> GTTGCCGACGAAATGCTATG
AGTTGCTGCATTCCCATTGT -> GTTGCTGCATTCCCATTGTC
AGTTGTACAAGCAGGGGGTT -> GTTGTACAAGCAGGGGGTTG
AGTTGTGAAGTCAAACTAAA -> GTTGTGAAGTCAAACTAAAA
AGTTGTGAAGTCAAACTAAC -> GTTGTGAAGTCAAACTAACG
AGTTGTGAAGTCAAACTAAG -> GTTGTGAAGTCAAACTAAGA,GTTGTGAAGTCAAACTAAGC
AGTTTAGTTGTGAAGTCAAA -> GTTTAGTTGTGAAGTCAAAC
AGTTTATACGCGGCACGGTT -> GTTTATACGCGGCACGGTTT
AGTTTGTCGACATGACACCG -> GTTTGTCGACATGACACCGG
ATAACAGTAAAATTTGCTGC -> TAACAGTAAAATTTGCTGCA
ATAACATTTGTCGACATGAC -> TAACATTTGTCGACATGACA
ATAACCTTGACTCCTTAGGC -> TAACCTTGACTCCTTAGGCA
ATAACGAAGACTTGAATTAC -> TAACGAAGACTTGAATTACT
ATAACGTCCCAGCCTCTTAA -> TAACGTCCCAGCCTCTTAAT
ATAAGCTCCCACAGTACAGC -> TAAGCTCCCACAGTACAGCG
ATAAGTATGCCTATACTCTT -> TAAGTATGCCTATACTCTTT
ATAATCGAGAGTCATCCTCA -> TAATCGAGAGTCATCCTCAG
ATAATGCAACCTAGAACTTT -> TAATGCAACCTAGAACTTTC
ATAATGTCTACGATCACGCG -> TAATGTCTACGATCACGCGA
ATACACCAGCACTAGGTGGA -> TACACCAGCACTAGGTGGAG
ATACACTTCGAGCTGCCTAC -> TACACTTCGAGCTGCCTACG
ATACAGGATAGAGGGCGCTA -> TACAGGATAGAGGGCGCTAC
ATACATTACATGTAAGGCTC -> TACATTACATGTAAGGCTCG
ATACCATAACCTTGACTCCT -> TACCATAACCTTGACTCCTT
ATACCGCCATAGCGACCTTT -> TACCGCCATAGCGACCTTTG
ATACCTAGACGGCTTACCTG -> TACCTAGACGGCTTACCTGC
ATACGCGGCACGGTTTAACC -> TACGCGGCACGGTTTAACCG
ATACGGGAAAGACCTCGCGC -> TACGGGAAAGACCTCGCGCC
ATACTATATCCGTGTACAAT -> TACTATATCCGTGTACAATA
ATACTCTTTTAATCTTCGAA -> TACTCTTTTAATCTTCGAAT
ATAGAGGGCGCTACAAGTGA -> TAGAGGGCGCTACAAGTGAT
ATAGATGTTCGGTTGCCACA -> TAGATGTTCGGTTGCCACAG
ATAGCGACCTTTGTCGACAT -> TAGCGACCTTTGTCGACATG
ATAGTGGAAGCTGCAACATA -> TAGTGGAAGCTGCAACATAC
ATATAACGAAGACTTGAATT -> TATAACGAAGACTTGAATTA
ATATATTAATTCCCAACACT -> TATATTAATTCCCAACACTA
ATATCACCCCGGCGTCATCT -> TATCACCCCGGCGTCATCTA
ATATCCGTGTACAATATTTT -> TATCCGTGTACAATATTTTA
ATATCTGTTGCGATGAGTTT -> TATCTGTTGCGATGAGTTTG
ATATCTTAGTGGACTAAATA -> TATCTTAGTGGACTAAATAC
ATATGCTAAGCGATGACGGA -> TATGCTAAGCGATGACGGAT
ATATGTACAGCGGTGGACGT -> TATGTACAGCGGTGGACGTA
ATATTAATTCCCAACACTAG -> TATTAATTCCCAACACTAGG
ATATTTTACTTCGCTTTCAG -> TATTTTACTTCGCTTTCAGA
ATCACACGGTAGCAGACGGA -> TCACACGGTAGCAGACGGAT
ATCACAGGGGAATCCTCGTC -> TCACAGGGGAATCCTCGTCG
ATCACATTGACAGAGTAGCT -> TCACATTGACAGAGTAGCTT
ATCACCCCGGCGTCATCTAG -> TCACCCCGGCGTCATCTAGC
ATCACGCGAGTAACCGGGTA -> TCACGCGAGTAACCGGGTAT
ATCACGGTACCGTGCCGGTA -> TCACGGTACCGTGCCGGTAC
ATCACGTGAACCGGCTGACG -> TCACGTGAACCGGCTGACGA
ATCAGCGTTGTAACACCCTC -> TCAGCGTTGTAACACCCTCG
ATCAGGGGTTCGCCTAATGA -> TCAGGGGTTCGCCTAATGAG
ATCAGTCTCGAGTTACCGAC -> TCAGTCTCGAGTTACCGACA
ATCAGTGTTATGGAGCTCGC -> TCAGTGTTATGGAGCTCGCA
ATCAGTTGACCCTCCGCGCG -> TCAGTTGACCCTCCGCGCGT
ATCCATCCCTTAGGCACCGC -> TCCATCCCTTAGGCACCGCG
ATCCATTTTATTCAACAGAG -> TCCATTTTATTCAACAGAGG
ATCCCTTAGGCACCGCGCCT -> TCCCTTAGGCACCGCGCCTC
ATCCGAAGAAGTTGTGAAGT -> TCCGAAGAAGTTGTGAAGTC
ATCCGCAATCTTATCAGGGG -> TCCGCAATCTTATCAGGGGT
ATCCGGACGCAAGAGTTGCC -> TCCGGACGCAAGAGTTGCCG
ATCCGTGTACAATATTTTAC -> TCCGTGTACAATATTTTACT
ATCCTCAGTTTATACGCGGC -> TCCTCAGTTTATACGCGGCA
ATCCTCGTCGCAGTGCGATT -> TCCTCGTCGCAGTGCGATTG
ATCGAACAGGAATTACTACG -> TCGAACAGGAATTACTACGA
ATCGAGAGTCATCCTCAGTT -> TCGAGAGTCATCCTCAGTTT
ATCGCCCTGACGCGATCTGG -> TCGCCCTGACGCGATCTGGT
ATCGGAACATAGTGGAAGCT -> TCGGAACATAGTGGAAGCTG
ATCGGCATTTTCCGTACACC -> TCGGCATTTTCCGTACACCG
ATCGTGGCTCGTCTTACCAT -> TCGTGGCTCGTCTTACCATA
ATCGTGTTCCTATGAATCCG -> TCGTGTTCCTATGAATCCGG
ATCTACATCGAACAGGAATT -> TCTACATCGAACAGGAATTA
ATCTACTTATACACCAGCAC -> TCTACTTATACACCAGCACT
ATCTAGCAGGCATACCTAGA -> TCTAGCAGGCATACCTAGAC
ATCTGGTCAAACGAAGAATC -> TCTGGTCAAACGAAGAATCA
ATCTGTTGCGATGAGTTTGT -> TCTGTTGCGATGAGTTTGTC
ATCTTAAAGGGCATGCGTAC -> TCTTAAAGGGCATGCGTACG
ATCTTAGTGGACTAAATACA -> TCTTAGTGGACTAAATACAG
ATCTTATCAGGGGTTCGCCT -> TCTTATCAGGGGTTCGCCTA
ATCTTCGAATTCAACGCTAT -> TCTTCGAATTCAACGCTATT
ATCTTCTGGTAGTAGTACTC -> TCTTCTGGTAGTAGTACTCT
ATGAAACATTGGCGTCGCAT -> TGAAACATTGGCGTCGCATA
ATGAATCCGGACGCAAGAGT -> TGAATCCGGACGCAAGAGTT
ATGACACCGAAATCCGAAGA -> TGACACCGAAATCCGAAGAA
ATGACACCGCTCGACAGCCT -> TGACACCGCTCGACAGCCTA
ATGACACCGGCAAAGAGTTT -> TGACACCGGCAAAGAGTTTA
ATGACACCGTTGCCGCCGTT -> TGACACCGTTGCCGCCGTTA
ATGACATAACGTCCCAGCCT -> TGACATAACGTCCCAGCCTC
ATGACGGATACATTACATGT -> TGACGGATACATTACATGTA
ATGACTATTCTGACATCACA -> TGACTATTCTGACATCACAC
ATGAGAGTCGCCAGTCAGGA -> TGAGAGTCGCCAGTCAGGAA
ATGAGCGACGCTTATCGGAA -> TGAGCGACGCTTATCGGAAC
ATGAGTGAACCGCATGTTAT -> TGAGTGAACCGCATGTTATT
ATGAGTTTGTCGACATGACA -> TGAGTTTGTCGACATGACAC
ATGCAACCTAGAACTTTCCG -> TGCAACCTAGAACTTTCCGT
ATGCAGTAGGTGGTGCGTTT -> TGCAGTAGGTGGTGCGTTTT
ATGCCCGCTAGGGCATGGAG -> TGCCCGCTAGGGCATGGAGG
ATGCCTATACTCTTTTAATC -> TGCCTATACTCTTTTAATCT
ATGCGATACCATAACCTTGA -> TGCGATACCATAACCTTGAC
ATGCGTACGAGGTGGATGGC -> TGCGTACGAGGTGGATGGCA
ATGCTAAGCGATGACGGATA -> TGCTAAGCGATGACGGATAC
ATGCTATGCTGATTTTCAAC -> TGCTATGCTGATTTTCAACG
ATGCTGATTTTCAACGGGCT -> TGCTGATTTTCAACGGGCTA
ATGGAGCTCGCATACCGCCA -> TGGAGCTCGCATACCGCCAT
ATGGAGGTTCCCGGAAATAT -> TGGAGGTTCCCGGAAATATA
ATGGCATCGTGTTCCTATGA -> TGGCATCGTGTTCCTATGAA
ATGGCATTTACCCCGAAATC -> TGGCATTTACCCCGAAATCT
ATGGCTGCTACCGCAACGCA -> TGGCTGCTACCGCAACGCAG
ATGGTTAATATAACGAAGAC -> TGGTTAATATAACGAAGACT
ATGGTTTTTACTCCTCACAC -> TGGTTTTTACTCCTCACACG
ATGTAAGGCTCGATAATGTC -> TGTAAGGCTCGATAATGTCT
ATGTACAGCGGTGGACGTAA -> TGTACAGCGGTGGACGTAAT
ATGTCTACGATCACGCGAGT -> TGTCTACGATCACGCGAGTA
ATGTGTATCGGCATTTTCCG -> TGTGTATCGGCATTTTCCGT
ATGTTATTCTACTCTCAAAC -> TGTTATTCTACTCTCAAACA
ATGTTCGGTTGCCACAGGTG -> TGTTCGGTTGCCACAGGTGG
ATGTTCTTCCGCCCCGCTAC -> TGTTCTTCCGCCCCGCTACA
ATGTTTCGTAATTAAACATA -> TGTTTCGTAATTAAACATAT
ATTAAACATATCTTAGTGGA -> TTAAACATATCTTAGTGGAC
ATTAATTCCCAACACTAGGG -> TTAATTCCCAACACTAGGGG
ATTACATGTAAGGCTCGATA -> TTACATGTAAGGCTCGATAA
ATTACTAATCCATTTTATTC -> TTACTAATCCATTTTATTCA
ATTACTACGAGTGAAGGCAG -> TTACTACGAGTGAAGGCAGC
ATTATGTTTCGTAATTAAAC -> TTATGTTTCGTAATTAAACA
ATTCAACAGAGGCATTGATT -> TTCAACAGAGGCATTGATTA
ATTCAACGCTATTGCCTGTG -> TTCAACGCTATTGCCTGTGC
ATTCAATCTACATCGAACAG -> TTCAATCTACATCGAACAGG
ATTCCCAACACTAGGGGAAA -> TTCCCAACACTAGGGGAAAT
ATTCCCATTGTCTTGCCGCT -> TTCCCATTGTCTTGCCGCTT
ATTCGCGCAGGGCCAGTGAA -> TTCGCGCAGGGCCAGTGAAC
ATTCGGACCCCTAGTTGTAC -> TTCGGACCCCTAGTTGTACA
ATTCTACTCTCAAACACCGT -> TTCTACTCTCAAACACCGTA
ATTCTGACATCACACGGTAG -> TTCTGACATCACACGGTAGC
ATTGACAGAGTAGCTTTAAA -> TTGACAGAGTAGCTTTAAAC
ATTGATTATGTTTCGTAATT -> TTGATTATGTTTCGTAATTA
ATTGCCTGTGCTTGTTTTCG -> TTGCCTGTGCTTGTTTTCGA
ATTGCTTTAAATGACATAAC -> TTGCTTTAAATGACATAACG
ATTGGCGTCGCATAACATTT -> TTGGCGTCGCATAACATTTG
ATTGTCGGGCATGAGTGAAC -> TTGTCGGGCATGAGTGAACC
ATTGTCTTGCCGCTTTATCA -> TTGTCTTGCCGCTTTATCAG
ATTGTTATGCCCGCTAGGGC -> TTGTTATGCCCGCTAGGGCA
ATTTACCCCGAAATCTACTT -> TTTACCCCGAAATCTACTTA
ATTTATTTGATTCGGACCCC -> TTTATTTGATTCGGACCCCT
ATTTGATTCGGACCCCTAGT -> TTTGATTCGGACCCCTAGTT
ATTTGCTGCAATCTTAAAGG -> TTTGCTGCAATCTTAAAGGG
ATTTGTACATCGTGGCTCGT -> TTTGTACATCGTGGCTCGTC
ATTTGTCGACATGACACCGA -> TTTGTCGACATGACACCGAA
ATTTTACTTCGCTTTCAGAG -> TTTTACTTCGCTTTCAGAGT
ATTTTATTCAACAGAGGCAT -> TTTTATTCAACAGAGGCATT
ATTTTCAACGGGCTAAAACG -> TTTTCAACGGGCTAAAACGT
ATTTTCCGTACACCGCTGCT -> TTTTCCGTACACCGCTGCTT
CAAAAGCGTGGCCGGTAATT -> AAAAGCGTGGCCGGTAATTG
CAAACACCGTAAATATGCTA -> AAACACCGTAAATATGCTAA
CAAACCTGACACAGACTCCG -> AAACCTGACACAGACTCCGA
CAAACGAAGAATCACATTGA -> AAACGAAGAATCACATTGAC
CAAACTAAAAATCACGGTAC -> AAACTAAAAATCACGGTACC
CAAACTAACGAATAATCGAG -> AAACTAACGAATAATCGAGA
CAAACTAAGAATATCACCCC -> AAACTAAGAATATCACCCCG
CAAACTAAGCCAAATTTATT -> AAACTAAGCCAAATTTATTT
CAAAGAGTTTAGTTGTGAAG -> AAAGAGTTTAGTTGTGAAGT
CAAATTTATTTGATTCGGAC -> AAATTTATTTGATTCGGACC
CAACACTAGGGGAAATCACG -> AACACTAGGGGAAATCACGT
CAACAGAGGCATTGATTATG -> AACAGAGGCATTGATTATGT
CAACATACTATATCCGTGTA -> AACATACTATATCCGTGTAC
CAACCTAGAACTTTCCGTCG -> AACCTAGAACTTTCCGTCGC
CAACGCAGGACTTGTCTGTT -> AACGCAGGACTTGTCTGTTC
CAACGCTATTGCCTGTGCTT -> AACGCTATTGCCTGTGCTTG
CAACGGGCTAAAACGTCTTT -> AACGGGCTAAAACGTCTTTT
CAACTTACACACCGACTGGT -> AACTTACACACCGACTGGTT
CAACTTTTCCTATCACAGGG -> AACTTTTCCTATCACAGGGG
CAAGAGTTGCCGACGAAATG -> AAGAGTTGCCGACGAAATGC
CAAGCAGGGGGTTGCGGATG -> AAGCAGGGGGTTGCGGATGC
CAAGGTGAAGAGGGATCGCC -> AAGGTGAAGAGGGATCGCCC
CAAGTCACTTCCCATAACAG -> AAGTCACTTCCCATAACAGT
CAAGTGATGTTCTTCCGCCC -> AAGTGATGTTCTTCCGCCCC
CAATATTTTACTTCGCTTTC -> AATATTTTACTTCGCTTTCA
CAATCTACATCGAACAGGAA -> AATCTACATCGAACAGGAAT
CAATCTTAAAGGGCATGCGT -> AATCTTAAAGGGCATGCGTA
CAATCTTATCAGGGGTTCGC -> AATCTTATCAGGGGTTCGCC
CACACCGACTGGTTATTGTT -> ACACCGACTGGTTATTGTTA
CACACGGGCGTAAGTAATGA -> ACACGGGCGTAAGTAATGAC
CACACGGTAGCAGACGGATC -> ACACGGTAGCAGACGGATCC
CACAGACTCCGATTCAATCT -> ACAGACTCCGATTCAATCTA
CACAGGGGAATCCTCGTCGC -> ACAGGGGAATCCTCGTCGCA
CACAGGTGGTAGCAACTTAC -> ACAGGTGGTAGCAACTTACA
CACAGTACAGCGGGGTCAGT -> ACAGTACAGCGGGGTCAGTT
CACATGAGCGACGCTTATCG -> ACATGAGCGACGCTTATCGG
CACATTGACAGAGTAGCTTT -> ACATTGACAGAGTAGCTTTA
CACCAGCACTAGGTGGAGCG -> ACCAGCACTAGGTGGAGCGG
CACCCCGGCGTCATCTAGCA -> ACCCCGGCGTCATCTAGCAG
CACCCTCGCGCGGGGAGGGA -> ACCCTCGCGCGGGGAGGGAT
CACCGAAATCCGAAGAAGTT -> ACCGAAATCCGAAGAAGTTG
CACCGACTGGTTATTGTTAT -> ACCGACTGGTTATTGTTATG
CACCGCGCCTCTCGAGCGGG -> ACCGCGCCTCTCGAGCGGGG
CACCGCTCGACAGCCTAGTT -> ACCGCTCGACAGCCTAGTTG
CACCGCTGCTTTTGTCGACA -> ACCGCTGCTTTTGTCGACAT
CACCGGCAAAGAGTTTAGTT -> ACCGGCAAAGAGTTTAGTTG
CACCGTAAATATGCTAAGCG -> ACCGTAAATATGCTAAGCGA
CACCGTTGCCGCCGTTAGTT -> ACCGTTGCCGCCGTTAGTTG
CACGCGAGTAACCGGGTATA -> ACGCGAGTAACCGGGTATAT
CACGGGCGTAAGTAATGACT -> ACGGGCGTAAGTAATGACTA
CACGGTACCGTGCCGGTACC -> ACGGTACCGTGCCGGTACCT
CACGGTAGCAGACGGATCCA -> ACGGTAGCAGACGGATCCAT
CACGGTTTAACCGCAAGGTG -> ACGGTTTAACCGCAAGGTGA
CACGTGAACCGGCTGACGAC -> ACGTGAACCGGCTGACGACC
CACTAGGGGAAATCACGTGA -> ACTAGGGGAAATCACGTGAA
CACTAGGTGGAGCGGTGAGA -> ACTAGGTGGAGCGGTGAGAA
CACTATGAAACATTGGCGTC -> ACTATGAAACATTGGCGTCG
CACTTCCCATAACAGTAAAA -> ACTTCCCATAACAGTAAAAT
CACTTCGAGCTGCCTACGTT -> ACTTCGAGCTGCCTACGTTT
CAGACGGATCCATCCCTTAG -> AGACGGATCCATCCCTTAGG
CAGACTCCGATTCAATCTAC -> AGACTCCGATTCAATCTACA
CAGAGGCATTGATTATGTTT -> AGAGGCATTGATTATGTTTC
CAGAGTAGCTTTAAACGGTG -> AGAGTAGCTTTAAACGGTGT
CAGAGTGTTAAGGACCGTGA -> AGAGTGTTAAGGACCGTGAG
CAGCACTAGGTGGAGCGGTG -> AGCACTAGGTGGAGCGGTGA
CAGCCCACATGAGCGACGCT -> AGCCCACATGAGCGACGCTT
CAGCCTAGTTGTGAAGTCAA -> AGCCTAGTTGTGAAGTCAAA
CAGCCTCTTAATTTGTACAT -> AGCCTCTTAATTTGTACATC
CAGCCTTATCAGTCTCGAGT -> AGCCTTATCAGTCTCGAGTT
CAGCGGGGTCAGTTGCTGCA -> AGCGGGGTCAGTTGCTGCAT
CAGCGGGTGTCGCTACCGTA -> AGCGGGTGTCGCTACCGTAC
CAGCGGTGGACGTAATAATG -> AGCGGTGGACGTAATAATGC
CAGCGTTGTAACACCCTCGC -> AGCGTTGTAACACCCTCGCG
CAGCTACTCAAGTCACTTCC -> AGCTACTCAAGTCACTTCCC
CAGGAAACTGACTTGTAGCC -> AGGAAACTGACTTGTAGCCT
CAGGAATTACTACGAGTGAA -> AGGAATTACTACGAGTGAAG
CAGGACTTGTCTGTTCAGCC -> AGGACTTGTCTGTTCAGCCC
CAGGATAGAGGGCGCTACAA -> AGGATAGAGGGCGCTACAAG
CAGGCATACCTAGACGGCTT -> AGGCATACCTAGACGGCTTA
CAGGGCCAGTGAACCTGATG -> AGGGCCAGTGAACCTGATGG
CAGGGCTGTTTTACTCGTGG -> AGGGCTGTTTTACTCGTGGG
CAGGGGAATCCTCGTCGCAG -> AGGGGAATCCTCGTCGCAGT
CAGGGGGTTGCGGATGCAGT -> AGGGGGTTGCGGATGCAGTA
CAGGGGTTCGCCTAATGAGA -> AGGGGTTCGCCTAATGAGAG
CAGGTGGTAGCAACTTACAC -> AGGTGGTAGCAACTTACACA
CAGTAAAATTTGCTGCAATC -> AGTAAAATTTGCTGCAATCT
CAGTAATCAGCGTTGTAACA -> AGTAATCAGCGTTGTAACAC
CAGTACAGCGGGGTCAGTTG -> AGTACAGCGGGGTCAGTTGC
CAGTAGGTGGTGCGTTTTCG -> AGTAGGTGGTGCGTTTTCGC
CAGTCAGGAAACTGACTTGT -> AGTCAGGAAACTGACTTGTA
CAGTCTCGAGTTACCGACAA -> AGTCTCGAGTTACCGACAAA
CAGTGAACCTGATGGCATTT -> AGTGAACCTGATGGCATTTA
CAGTGCGATTGCTTTAAATG -> AGTGCGATTGCTTTAAATGA
CAGTGTTATGGAGCTCGCAT -> AGTGTTATGGAGCTCGCATA
CAGTTGACCCTCCGCGCGTT -> AGTTGACCCTCCGCGCGTTC
CAGTTGCTGCATTCCCATTG -> AGTTGCTGCATTCCCATTGT
CAGTTTATACGCGGCACGGT -> AGTTTATACGCGGCACGGTT
CATAACAGTAAAATTTGCTG -> ATAACAGTAAAATTTGCTGC
CATAACATTTGTCGACATGA -> ATAACATTTGTCGACATGAC
CATAACCTTGACTCCTTAGG -> ATAACCTTGACTCCTTAGGC
CATAACGTCCCAGCCTCTTA -> ATAACGTCCCAGCCTCTTAA
CATAAGTATGCCTATACTCT -> ATAAGTATGCCTATACTCTT
CATACCGCCATAGCGACCTT -> ATACCGCCATAGCGACCTTT
CATACCTAGACGGCTTACCT -> ATACCTAGACGGCTTACCTG
CATACTATATCCGTGTACAA -> ATACTATATCCGTGTACAAT
CATAGATGTTCGGTTGCCAC -> ATAGATGTTCGGTTGCCACA
CATAGCGACCTTTGTCGACA -> ATAGCGACCTTTGTCGACAT
CATAGTGGAAGCTGCAACAT -> ATAGTGGAAGCTGCAACATA
CATATCTTAGTGGACTAAAT -> ATATCTTAGTGGACTAAATA
CATATGTACAGCGGTGGACG -> ATATGTACAGCGGTGGACGT
CATCACACGGTAGCAGACGG -> ATCACACGGTAGCAGACGGA
CATCAGTGTTATGGAGCTCG -> ATCAGTGTTATGGAGCTCGC
CATCCCTTAGGCACCGCGCC -> ATCCCTTAGGCACCGCGCCT
CATCCTCAGTTTATACGCGG -> ATCCTCAGTTTATACGCGGC
CATCGAACAGGAATTACTAC -> ATCGAACAGGAATTACTACG
CATCGTGGCTCGTCTTACCA -> ATCGTGGCTCGTCTTACCAT
CATCGTGTTCCTATGAATCC -> ATCGTGTTCCTATGAATCCG
CATCTAGCAGGCATACCTAG -> ATCTAGCAGGCATACCTAGA
CATGACACCGAAATCCGAAG -> ATGACACCGAAATCCGAAGA
CATGACACCGCTCGACAGCC -> ATGACACCGCTCGACAGCCT
CATGACACCGGCAAAGAGTT -> ATGACACCGGCAAAGAGTTT
CATGACACCGTTGCCGCCGT -> ATGACACCGTTGCCGCCGTT
CATGAGCGACGCTTATCGGA -> ATGAGCGACGCTTATCGGAA
CATGAGTGAACCGCATGTTA -> ATGAGTGAACCGCATGTTAT
CATGCGATACCATAACCTTG -> ATGCGATACCATAACCTTGA
CATGCGTACGAGGTGGATGG -> ATGCGTACGAGGTGGATGGC
CATGGAGGTTCCCGGAAATA -> ATGGAGGTTCCCGGAAATAT
CATGGCTGCTACCGCAACGC -> ATGGCTGCTACCGCAACGCA
CATGTAAGGCTCGATAATGT -> ATGTAAGGCTCGATAATGTC
CATGTTATTCTACTCTCAAA -> ATGTTATTCTACTCTCAAAC
CATTACATGTAAGGCTCGAT -> ATTACATGTAAGGCTCGATA
CATTCCCATTGTCTTGCCGC -> ATTCCCATTGTCTTGCCGCT
CATTCGCGCAGGGCCAGTGA -> ATTCGCGCAGGGCCAGTGAA
CATTGACAGAGTAGCTTTAA -> ATTGACAGAGTAGCTTTAAA
CATTGATTATGTTTCGTAAT -> ATTGATTATGTTTCGTAATT
CATTGGCGTCGCATAACATT -> ATTGGCGTCGCATAACATTT
CATTGTCTTGCCGCTTTATC -> ATTGTCTTGCCGCTTTATCA
CATTTACCCCGAAATCTACT -> ATTTACCCCGAAATCTACTT
CATTTGTCGACATGACACCG -> ATTTGTCGACATGACACCGA
CATTTTATTCAACAGAGGCA -> ATTTTATTCAACAGAGGCAT
CATTTTCCGTACACCGCTGC -> ATTTTCCGTACACCGCTGCT
CCAAATTTATTTGATTCGGA -> CAAATTTATTTGATTCGGAC
CCAACACTAGGGGAAATCAC -> CAACACTAGGGGAAATCACG
CCACAGGTGGTAGCAACTTA -> CACAGGTGGTAGCAACTTAC
CCACAGTACAGCGGGGTCAG -> CACAGTACAGCGGGGTCAGT
CCACATGAGCGACGCTTATC -> CACATGAGCGACGCTTATCG
CCAGCACTAGGTGGAGCGGT -> CAGCACTAGGTGGAGCGGTG
CCAGCCTCTTAATTTGTACA -> CAGCCTCTTAATTTGTACAT
CCAGTCAGGAAACTGACTTG -> CAGTCAGGAAACTGACTTGT
CCAGTGAACCTGATGGCATT -> CAGTGAACCTGATGGCATTT
CCATAACAGTAAAATTTGCT -> CATAACAGTAAAATTTGCTG
CCATAACCTTGACTCCTTAG -> CATAACCTTGACTCCTTAGG
CCATAGATGTTCGGTTGCCA -> CATAGATGTTCGGTTGCCAC
CCATAGCGACCTTTGTCGAC -> CATAGCGACCTTTGTCGACA
CCATCCCTTAGGCACCGCGC -> CATCCCTTAGGCACCGCGCC
CCATTGTCTTGCCGCTTTAT -> CATTGTCTTGCCGCTTTATC
CCATTTTATTCAACAGAGGC -> CATTTTATTCAACAGAGGCA
CCCAACACTAGGGGAAATCA -> CCAACACTAGGGGAAATCAC
CCCACAGTACAGCGGGGTCA -> CCACAGTACAGCGGGGTCAG
CCCACATGAGCGACGCTTAT -> CCACATGAGCGACGCTTATC
CCCAGCCTCTTAATTTGTAC -> CCAGCCTCTTAATTTGTACA
CCCATAACAGTAAAATTTGC -> CCATAACAGTAAAATTTGCT
CCCATTGTCTTGCCGCTTTA -> CCATTGTCTTGCCGCTTTAT
CCCCGAAATCTACTTATACA -> CCCGAAATCTACTTATACAC
CCCCGCTACATTCGCGCAGG -> CCCGCTACATTCGCGCAGGG
CCCCGGCGTCATCTAGCAGG -> CCCGGCGTCATCTAGCAGGC
CCCCGGGGTGAACAGCGGGT -> CCCGGGGTGAACAGCGGGTG
CCCCTAGTTGTACAAGCAGG -> CCCTAGTTGTACAAGCAGGG
CCCGAAATCTACTTATACAC -> CCGAAATCTACTTATACACC
CCCGCTACATTCGCGCAGGG -> CCGCTACATTCGCGCAGGGC
CCCGCTAGGGCATGGAGGTT -> CCGCTAGGGCATGGAGGTTC
CCCGGAAATATATTAATTCC -> CCGGAAATATATTAATTCCC
CCCGGCGTCATCTAGCAGGC -> CCGGCGTCATCTAGCAGGCA
CCCGGGGTGAACAGCGGGTG -> CCGGGGTGAACAGCGGGTGT
CCCTACGGCTCCTAGCATAT -> CCTACGGCTCCTAGCATATG
CCCTAGCTATACGGGAAAGA -> CCTAGCTATACGGGAAAGAC
CCCTAGTTGTACAAGCAGGG -> CCTAGTTGTACAAGCAGGGG
CCCTCCGCGCGTTCGCATAA -> CCTCCGCGCGTTCGCATAAG
CCCTCGCGCGGGGAGGGATG -> CCTCGCGCGGGGAGGGATGG
CCCTGACGCGATCTGGTCAA -> CCTGACGCGATCTGGTCAAA
CCCTTAGGCACCGCGCCTCT -> CCTTAGGCACCGCGCCTCTC
CCCTTCTCAGCCTTATCAGT -> CCTTCTCAGCCTTATCAGTC
CCGAAATCCGAAGAAGTTGT -> CGAAATCCGAAGAAGTTGTG
CCGAAATCTACTTATACACC -> CGAAATCTACTTATACACCA
CCGAAGAAGTTGTGAAGTCA -> CGAAGAAGTTGTGAAGTCAA
CCGAAGGACATGCGATACCA -> CGAAGGACATGCGATACCAT
CCGACAAAAGCGTGGCCGGT -> CGACAAAAGCGTGGCCGGTA
CCGACGAAATGCTATGCTGA -> CGACGAAATGCTATGCTGAT
CCGACTGGTTATTGTTATGC -> CGACTGGTTATTGTTATGCC
CCGATAAGCTCCCACAGTAC -> CGATAAGCTCCCACAGTACA
CCGATTCAATCTACATCGAA -> CGATTCAATCTACATCGAAC
CCGCAACGCAGGACTTGTCT -> CGCAACGCAGGACTTGTCTG
CCGCAAGGTGAAGAGGGATC -> CGCAAGGTGAAGAGGGATCG
CCGCAATCTTATCAGGGGTT -> CGCAATCTTATCAGGGGTTC
CCGCATGTTATTCTACTCTC -> CGCATGTTATTCTACTCTCA
CCGCCATAGCGACCTTTGTC -> CGCCATAGCGACCTTTGTCG
CCGCCCCGCTACATTCGCGC -> CGCCCCGCTACATTCGCGCA
CCGCCGTTAGTTGTGAAGTC -> CGCCGTTAGTTGTGAAGTCA
CCGCGCCTCTCGAGCGGGGT -> CGCGCCTCTCGAGCGGGGTT
CCGCGCGTTCGCATAAGTAT -> CGCGCGTTCGCATAAGTATG
CCGCTACATTCGCGCAGGGC -> CGCTACATTCGCGCAGGGCC
CCGCTAGGGCATGGAGGTTC -> CGCTAGGGCATGGAGGTTCC
CCGCTCGACAGCCTAGTTGT -> CGCTCGACAGCCTAGTTGTG
CCGCTGCTTTTGTCGACATG -> CGCTGCTTTTGTCGACATGA
CCGCTTTATCAGTTGACCCT -> CGCTTTATCAGTTGACCCTC
CCGGAAATATATTAATTCCC -> CGGAAATATATTAATTCCCA
CCGGACGCAAGAGTTGCCGA -> CGGACGCAAGAGTTGCCGAC
CCGGCAAAGAGTTTAGTTGT -> CGGCAAAGAGTTTAGTTGTG
CCGGCGTCATCTAGCAGGCA -> CGGCGTCATCTAGCAGGCAT
CCGGCTGACGACCGATAAGC -> CGGCTGACGACCGATAAGCT
CCGGGGTGAACAGCGGGTGT -> CGGGGTGAACAGCGGGTGTC
CCGGGTATATCTGTTGCGAT -> CGGGTATATCTGTTGCGATG
CCGGTAATTGTCGGGCATGA -> CGGTAATTGTCGGGCATGAG
CCGGTACCTCCCTAGCTATA -> CGGTACCTCCCTAGCTATAC
CCGTAAATATGCTAAGCGAT -> CGTAAATATGCTAAGCGATG
CCGTACACCGCTGCTTTTGT -> CGTACACCGCTGCTTTTGTC
CCGTACCGTCTATTGCGCTA -> CGTACCGTCTATTGCGCTAA
CCGTCGCTACTTACAAACCT -> CGTCGCTACTTACAAACCTG
CCGTGAGTATGGTTAATATA -> CGTGAGTATGGTTAATATAA
CCGTGCCGGTACCTCCCTAG -> CGTGCCGGTACCTCCCTAGC
CCGTGTACAATATTTTACTT -> CGTGTACAATATTTTACTTC
CCGTTAGTTGTGAAGTCAAA -> CGTTAGTTGTGAAGTCAAAC
CCGTTGCCGCCGTTAGTTGT -> CGTTGCCGCCGTTAGTTGTG
CCTAAGGAGGGTGCCCTACG -> CTAAGGAGGGTGCCCTACGG
CCTAAGTCCCCGGGGTGAAC -> CTAAGTCCCCGGGGTGAACA
CCTAATGAGAGTCGCCAGTC -> CTAATGAGAGTCGCCAGTCA
CCTACGGCTCCTAGCATATG -> CTACGGCTCCTAGCATATGT
CCTACGTTTGCACTATGAAA -> CTACGTTTGCACTATGAAAC
CCTAGAACTTTCCGTCGCTA -> CTAGAACTTTCCGTCGCTAC
CCTAGACGGCTTACCTGCTT -> CTAGACGGCTTACCTGCTTG
CCTAGCATATGTACAGCGGT -> CTAGCATATGTACAGCGGTG
CCTAGCTATACGGGAAAGAC -> CTAGCTATACGGGAAAGACC
CCTAGTTGTACAAGCAGGGG -> CTAGTTGTACAAGCAGGGGG
CCTAGTTGTGAAGTCAAACT -> CTAGTTGTGAAGTCAAACTA
CCTATACTCTTTTAATCTTC -> CTATACTCTTTTAATCTTCG
CCTATCACAGGGGAATCCTC -> CTATCACAGGGGAATCCTCG
CCTATGAATCCGGACGCAAG -> CTATGAATCCGGACGCAAGA
CCTCACACGGGCGTAAGTAA -> CTCACACGGGCGTAAGTAAT
CCTCAGTTTATACGCGGCAC -> CTCAGTTTATACGCGGCACG
CCTCCCTAGCTATACGGGAA -> CTCCCTAGCTATACGGGAAA
CCTCCGCGCGTTCGCATAAG -> CTCCGCGCGTTCGCATAAGT
CCTCGCGCCGAAGGACATGC -> CTCGCGCCGAAGGACATGCG
CCTCGCGCGGGGAGGGATGG -> CTCGCGCGGGGAGGGATGGT
CCTCGTCGCAGTGCGATTGC -> CTCGTCGCAGTGCGATTGCT
CCTCTCGAGCGGGGTTGCAG -> CTCTCGAGCGGGGTTGCAGG
CCTCTTAATTTGTACATCGT -> CTCTTAATTTGTACATCGTG
CCTGACACAGACTCCGATTC -> CTGACACAGACTCCGATTCA
CCTGACGCGATCTGGTCAAA -> CTGACGCGATCTGGTCAAAC
CCTGATGGCATTTACCCCGA -> CTGATGGCATTTACCCCGAA
CCTGCTTGCGATGTGTATCG -> CTGCTTGCGATGTGTATCGG
CCTGTGCTTGTTTTCGAAGA -> CTGTGCTTGTTTTCGAAGAG
CCTTAGGCACCGCGCCTCTC -> CTTAGGCACCGCGCCTCTCG
CCTTAGGCATCAGTGTTATG -> CTTAGGCATCAGTGTTATGG
CCTTATCAGTCTCGAGTTAC -> CTTATCAGTCTCGAGTTACC
CCTTCTCAGCCTTATCAGTC -> CTTCTCAGCCTTATCAGTCT
CCTTGACTCCTTAGGCATCA -> CTTGACTCCTTAGGCATCAG
CCTTTGTCGACATGACACCG -> CTTTGTCGACATGACACCGC
CGAAATCCGAAGAAGTTGTG -> GAAATCCGAAGAAGTTGTGA
CGAAATCTACTTATACACCA -> GAAATCTACTTATACACCAG
CGAAATGCTATGCTGATTTT -> GAAATGCTATGCTGATTTTC
CGAACAGGAATTACTACGAG -> GAACAGGAATTACTACGAGT
CGAAGAAGTTGTGAAGTCAA -> GAAGAAGTTGTGAAGTCAAA
CGAAGAATCACATTGACAGA -> GAAGAATCACATTGACAGAG
CGAAGACTTGAATTACTAAT -> GAAGACTTGAATTACTAATC
CGAAGAGGCCCTTCTCAGCC -> GAAGAGGCCCTTCTCAGCCT
CGAAGGACATGCGATACCAT -> GAAGGACATGCGATACCATA
CGAATAATCGAGAGTCATCC -> GAATAATCGAGAGTCATCCT
CGAATTCAACGCTATTGCCT -> GAATTCAACGCTATTGCCTG
CGACAAAAGCGTGGCCGGTA -> GACAAAAGCGTGGCCGGTAA
CGACAGCCTAGTTGTGAAGT -> GACAGCCTAGTTGTGAAGTC
CGACATGACACCGAAATCCG -> GACATGACACCGAAATCCGA
CGACATGACACCGCTCGACA -> GACATGACACCGCTCGACAG
CGACATGACACCGGCAAAGA -> GACATGACACCGGCAAAGAG
CGACATGACACCGTTGCCGC -> GACATGACACCGTTGCCGCC
CGACCGATAAGCTCCCACAG -> GACCGATAAGCTCCCACAGT
CGACCTTTGTCGACATGACA -> GACCTTTGTCGACATGACAC
CGACGAAATGCTATGCTGAT -> GACGAAATGCTATGCTGATT
CGACGCTTATCGGAACATAG -> GACGCTTATCGGAACATAGT
CGACTGGTTATTGTTATGCC -> GACTGGTTATTGTTATGCCC
CGAGAGTCATCCTCAGTTTA -> GAGAGTCATCCTCAGTTTAT
CGAGCGGGGTTGCAGGGCTG -> GAGCGGGGTTGCAGGGCTGT
CGAGCTGCCTACGTTTGCAC -> GAGCTGCCTACGTTTGCACT
CGAGGTGGATGGCATCGTGT -> GAGGTGGATGGCATCGTGTT
CGAGTAACCGGGTATATCTG -> GAGTAACCGGGTATATCTGT
CGAGTGAAGGCAGCTACTCA -> GAGTGAAGGCAGCTACTCAA
CGAGTTACCGACAAAAGCGT -> GAGTTACCGACAAAAGCGTG
CGATAAGCTCCCACAGTACA -> GATAAGCTCCCACAGTACAG
CGATAATGTCTACGATCACG -> GATAATGTCTACGATCACGC
CGATACCATAACCTTGACTC -> GATACCATAACCTTGACTCC
CGATCACGCGAGTAACCGGG -> GATCACGCGAGTAACCGGGT
CGATCTGGTCAAACGAAGAA -> GATCTGGTCAAACGAAGAAT
CGATGACGGATACATTACAT -> GATGACGGATACATTACATG
CGATGAGTTTGTCGACATGA -> GATGAGTTTGTCGACATGAC
CGATGTGTATCGGCATTTTC -> GATGTGTATCGGCATTTTCC
CGATTCAATCTACATCGAAC -> GATTCAATCTACATCGAACA
CGATTGCTTTAAATGACATA -> GATTGCTTTAAATGACATAA
CGCAACGCAGGACTTGTCTG -> GCAACGCAGGACTTGTCTGT
CGCAAGAGTTGCCGACGAAA -> GCAAGAGTTGCCGACGAAAT
CGCAAGGTGAAGAGGGATCG -> GCAAGGTGAAGAGGGATCGC
CGCAATCTTATCAGGGGTTC -> GCAATCTTATCAGGGGTTCG
CGCAGGACTTGTCTGTTCAG -> GCAGGACTTGTCTGTTCAGC
CGCAGGGCCAGTGAACCTGA -> GCAGGGCCAGTGAACCTGAT
CGCAGTGCGATTGCTTTAAA -> GCAGTGCGATTGCTTTAAAT
CGCATAACATTTGTCGACAT -> GCATAACATTTGTCGACATG
CGCATAAGTATGCCTATACT -> GCATAAGTATGCCTATACTC
CGCATACCGCCATAGCGACC -> GCATACCGCCATAGCGACCT
CGCATGTTATTCTACTCTCA -> GCATGTTATTCTACTCTCAA
CGCCAGTCAGGAAACTGACT -> GCCAGTCAGGAAACTGACTT
CGCCATAGCGACCTTTGTCG -> GCCATAGCGACCTTTGTCGA
CGCCCCGCTACATTCGCGCA -> GCCCCGCTACATTCGCGCAG
CGCCCTGACGCGATCTGGTC -> GCCCTGACGCGATCTGGTCA
CGCCGAAGGACATGCGATAC -> GCCGAAGGACATGCGATACC
CGCCGTTAGTTGTGAAGTCA -> GCCGTTAGTTGTGAAGTCAA
CGCCTAATGAGAGTCGCCAG -> GCCTAATGAGAGTCGCCAGT
CGCCTCTCGAGCGGGGTTGC -> GCCTCTCGAGCGGGGTTGCA
CGCGAGTAACCGGGTATATC -> GCGAGTAACCGGGTATATCT
CGCGATCTGGTCAAACGAAG -> GCGATCTGGTCAAACGAAGA
CGCGCAGGGCCAGTGAACCT -> GCGCAGGGCCAGTGAACCTG
CGCGCCGAAGGACATGCGAT -> GCGCCGAAGGACATGCGATA
CGCGCCTCTCGAGCGGGGTT -> GCGCCTCTCGAGCGGGGTTG
CGCGCGGGGAGGGATGGTTT -> GCGCGGGGAGGGATGGTTTT
CGCGCGTTCGCATAAGTATG -> GCGCGTTCGCATAAGTATGC
CGCGGCACGGTTTAACCGCA -> GCGGCACGGTTTAACCGCAA
CGCGGGGAGGGATGGTTTTT -> GCGGGGAGGGATGGTTTTTA
CGCGTTCGCATAAGTATGCC -> GCGTTCGCATAAGTATGCCT
CGCTACAAGTGATGTTCTTC -> GCTACAAGTGATGTTCTTCC
CGCTACATTCGCGCAGGGCC -> GCTACATTCGCGCAGGGCCA
CGCTACCGTACCGTCTATTG -> GCTACCGTACCGTCTATTGC
CGCTACTTACAAACCTGACA -> GCTACTTACAAACCTGACAC
CGCTAGGGCATGGAGGTTCC -> GCTAGGGCATGGAGGTTCCC
CGCTATTGCCTGTGCTTGTT -> GCTATTGCCTGTGCTTGTTT
CGCTCGACAGCCTAGTTGTG -> GCTCGACAGCCTAGTTGTGA
CGCTGCTTTTGTCGACATGA -> GCTGCTTTTGTCGACATGAC
CGCTTATCGGAACATAGTGG -> GCTTATCGGAACATAGTGGA
CGCTTGATCTTCTGGTAGTA -> GCTTGATCTTCTGGTAGTAG
CGCTTTATCAGTTGACCCTC -> GCTTTATCAGTTGACCCTCC
CGCTTTCAGAGTGTTAAGGA -> GCTTTCAGAGTGTTAAGGAC
CGGAAATATATTAATTCCCA -> GGAAATATATTAATTCCCAA
CGGAACATAGTGGAAGCTGC -> GGAACATAGTGGAAGCTGCA
CGGACCCCTAGTTGTACAAG -> GGACCCCTAGTTGTACAAGC
CGGACGCAAGAGTTGCCGAC -> GGACGCAAGAGTTGCCGACG
CGGATACATTACATGTAAGG -> GGATACATTACATGTAAGGC
CGGATCCATCCCTTAGGCAC -> GGATCCATCCCTTAGGCACC
CGGATGCAGTAGGTGGTGCG -> GGATGCAGTAGGTGGTGCGT
CGGCAAAGAGTTTAGTTGTG -> GGCAAAGAGTTTAGTTGTGA
CGGCACGGTTTAACCGCAAG -> GGCACGGTTTAACCGCAAGG
CGGCATTTTCCGTACACCGC -> GGCATTTTCCGTACACCGCT
CGGCGTCATCTAGCAGGCAT -> GGCGTCATCTAGCAGGCATA
CGGCTCCTAGCATATGTACA -> GGCTCCTAGCATATGTACAG
CGGCTGACGACCGATAAGCT -> GGCTGACGACCGATAAGCTC
CGGCTTACCTGCTTGCGATG -> GGCTTACCTGCTTGCGATGT
CGGGAAAGACCTCGCGCCGA -> GGGAAAGACCTCGCGCCGAA
CGGGCATGAGTGAACCGCAT -> GGGCATGAGTGAACCGCATG
CGGGCGTAAGTAATGACTAT -> GGGCGTAAGTAATGACTATT
CGGGCTAAAACGTCTTTTGA -> GGGCTAAAACGTCTTTTGAC
CGGGGAGGGATGGTTTTTAC -> GGGGAGGGATGGTTTTTACT
CGGGGTCAGTTGCTGCATTC -> GGGGTCAGTTGCTGCATTCC
CGGGGTGAACAGCGGGTGTC -> GGGGTGAACAGCGGGTGTCG
CGGGGTTGCAGGGCTGTTTT -> GGGGTTGCAGGGCTGTTTTA
CGGGTATATCTGTTGCGATG -> GGGTATATCTGTTGCGATGA
CGGGTGTCGCTACCGTACCG -> GGGTGTCGCTACCGTACCGT
CGGTAATTGTCGGGCATGAG -> GGTAATTGTCGGGCATGAGT
CGGTACCGTGCCGGTACCTC -> GGTACCGTGCCGGTACCTCC
CGGTACCTCCCTAGCTATAC -> GGTACCTCCCTAGCTATACG
CGGTAGCAGACGGATCCATC -> GGTAGCAGACGGATCCATCC
CGGTGAGAACCTAAGTCCCC -> GGTGAGAACCTAAGTCCCCG
CGGTGGACGTAATAATGCAA -> GGTGGACGTAATAATGCAAC
CGGTGTTCTCTGCAGTAATC -> GGTGTTCTCTGCAGTAATCA
CGGTTGCCACAGGTGGTAGC -> GGTTGCCACAGGTGGTAGCA
CGGTTTAACCGCAAGGTGAA -> GGTTTAACCGCAAGGTGAAG
CGTAAATATGCTAAGCGATG -> GTAAATATGCTAAGCGATGA
CGTAAGTAATGACTATTCTG -> GTAAGTAATGACTATTCTGA
CGTAATAATGCAACCTAGAA -> GTAATAATGCAACCTAGAAC
CGTAATTAAACATATCTTAG -> GTAATTAAACATATCTTAGT
CGTACACCGCTGCTTTTGTC -> GTACACCGCTGCTTTTGTCG
CGTACCGTCTATTGCGCTAA -> GTACCGTCTATTGCGCTAAT
CGTACGAGGTGGATGGCATC -> GTACGAGGTGGATGGCATCG
CGTCATCTAGCAGGCATACC -> GTCATCTAGCAGGCATACCT
CGTCCCAGCCTCTTAATTTG -> GTCCCAGCCTCTTAATTTGT
CGTCGCAGTGCGATTGCTTT -> GTCGCAGTGCGATTGCTTTA
CGTCGCATAACATTTGTCGA -> GTCGCATAACATTTGTCGAC
CGTCGCTACTTACAAACCTG -> GTCGCTACTTACAAACCTGA
CGTCTTACCATAGATGTTCG -> GTCTTACCATAGATGTTCGG
CGTCTTTTGACAACTTTTCC -> GTCTTTTGACAACTTTTCCT
CGTGAACCGGCTGACGACCG -> GTGAACCGGCTGACGACCGA
CGTGAGTATGGTTAATATAA -> GTGAGTATGGTTAATATAAC
CGTGCCGGTACCTCCCTAGC -> GTGCCGGTACCTCCCTAGCT
CGTGGCCGGTAATTGTCGGG -> GTGGCCGGTAATTGTCGGGC
CGTGGCTCGTCTTACCATAG -> GTGGCTCGTCTTACCATAGA
CGTGGGATACACTTCGAGCT -> GTGGGATACACTTCGAGCTG
CGTGTACAATATTTTACTTC -> GTGTACAATATTTTACTTCG
CGTGTTCCTATGAATCCGGA -> GTGTTCCTATGAATCCGGAC
CGTTAGTTGTGAAGTCAAAC -> GTTAGTTGTGAAGTCAAACT
CGTTCGCATAAGTATGCCTA -> GTTCGCATAAGTATGCCTAT
CGTTGCCGCCGTTAGTTGTG -> GTTGCCGCCGTTAGTTGTGA
CGTTGTAACACCCTCGCGCG -> GTTGTAACACCCTCGCGCGG
CGTTTGCACTATGAAACATT -> GTTTGCACTATGAAACATTG
CGTTTTCGCTTGATCTTCTG -> GTTTTCGCTTGATCTTCTGG
CTAAAAATCACGGTACCGTG -> TAAAAATCACGGTACCGTGC
CTAAAACGTCTTTTGACAAC -> TAAAACGTCTTTTGACAACT
CTAAATACAGGATAGAGGGC -> TAAATACAGGATAGAGGGCG
CTAACGAATAATCGAGAGTC -> TAACGAATAATCGAGAGTCA
CTAAGAATATCACCCCGGCG -> TAAGAATATCACCCCGGCGT
CTAAGCCAAATTTATTTGAT -> TAAGCCAAATTTATTTGATT
CTAAGCGATGACGGATACAT -> TAAGCGATGACGGATACATT
CTAAGGAGGGTGCCCTACGG -> TAAGGAGGGTGCCCTACGGC
CTAAGTCCCCGGGGTGAACA -> TAAGTCCCCGGGGTGAACAG
CTAATCCATTTTATTCAACA -> TAATCCATTTTATTCAACAG
CTAATGAGAGTCGCCAGTCA -> TAATGAGAGTCGCCAGTCAG
CTACAAGTGATGTTCTTCCG -> TACAAGTGATGTTCTTCCGC
CTACATCGAACAGGAATTAC -> TACATCGAACAGGAATTACT
CTACATTCGCGCAGGGCCAG -> TACATTCGCGCAGGGCCAGT
CTACCGCAACGCAGGACTTG -> TACCGCAACGCAGGACTTGT
CTACCGTACCGTCTATTGCG -> TACCGTACCGTCTATTGCGC
CTACGAGTGAAGGCAGCTAC -> TACGAGTGAAGGCAGCTACT
CTACGATCACGCGAGTAACC -> TACGATCACGCGAGTAACCG
CTACGGCTCCTAGCATATGT -> TACGGCTCCTAGCATATGTA
CTACGTTTGCACTATGAAAC -> TACGTTTGCACTATGAAACA
CTACTCAAGTCACTTCCCAT -> TACTCAAGTCACTTCCCATA
CTACTCTCAAACACCGTAAA -> TACTCTCAAACACCGTAAAT
CTACTTACAAACCTGACACA -> TACTTACAAACCTGACACAG
CTACTTATACACCAGCACTA -> TACTTATACACCAGCACTAG
CTAGAACTTTCCGTCGCTAC -> TAGAACTTTCCGTCGCTACT
CTAGACGGCTTACCTGCTTG -> TAGACGGCTTACCTGCTTGC
CTAGCAGGCATACCTAGACG -> TAGCAGGCATACCTAGACGG
CTAGCATATGTACAGCGGTG -> TAGCATATGTACAGCGGTGG
CTAGCTATACGGGAAAGACC -> TAGCTATACGGGAAAGACCT
CTAGGGCATGGAGGTTCCCG -> TAGGGCATGGAGGTTCCCGG
CTAGGGGAAATCACGTGAAC -> TAGGGGAAATCACGTGAACC
CTAGGTGGAGCGGTGAGAAC -> TAGGTGGAGCGGTGAGAACC
CTAGTGATCCGCAATCTTAT -> TAGTGATCCGCAATCTTATC
CTAGTTGTACAAGCAGGGGG -> TAGTTGTACAAGCAGGGGGT
CTAGTTGTGAAGTCAAACTA -> TAGTTGTGAAGTCAAACTAA
CTATACGGGAAAGACCTCGC -> TATACGGGAAAGACCTCGCG
CTATACTCTTTTAATCTTCG -> TATACTCTTTTAATCTTCGA
CTATATCCGTGTACAATATT -> TATATCCGTGTACAATATTT
CTATCACAGGGGAATCCTCG -> TATCACAGGGGAATCCTCGT
CTATGAAACATTGGCGTCGC -> TATGAAACATTGGCGTCGCA
CTATGAATCCGGACGCAAGA -> TATGAATCCGGACGCAAGAG
CTATGCTGATTTTCAACGGG -> TATGCTGATTTTCAACGGGC
CTATTCTGACATCACACGGT -> TATTCTGACATCACACGGTA
CTATTGCCTGTGCTTGTTTT -> TATTGCCTGTGCTTGTTTTC
CTCAAACACCGTAAATATGC -> TCAAACACCGTAAATATGCT
CTCAAGTCACTTCCCATAAC -> TCAAGTCACTTCCCATAACA
CTCACACGGGCGTAAGTAAT -> TCACACGGGCGTAAGTAATG
CTCAGCCTTATCAGTCTCGA -> TCAGCCTTATCAGTCTCGAG
CTCAGTTTATACGCGGCACG -> TCAGTTTATACGCGGCACGG
CTCATGGCTGCTACCGCAAC -> TCATGGCTGCTACCGCAACG
CTCCCACAGTACAGCGGGGT -> TCCCACAGTACAGCGGGGTC
CTCCCTAGCTATACGGGAAA -> TCCCTAGCTATACGGGAAAG
CTCCGATTCAATCTACATCG -> TCCGATTCAATCTACATCGA
CTCCGCGCGTTCGCATAAGT -> TCCGCGCGTTCGCATAAGTA
CTCCTAGCATATGTACAGCG -> TCCTAGCATATGTACAGCGG
CTCCTCACACGGGCGTAAGT -> TCCTCACACGGGCGTAAGTA
CTCCTTAGGCATCAGTGTTA -> TCCTTAGGCATCAGTGTTAT
CTCGACAGCCTAGTTGTGAA -> TCGACAGCCTAGTTGTGAAG
CTCGAGCGGGGTTGCAGGGC -> TCGAGCGGGGTTGCAGGGCT
CTCGAGTTACCGACAAAAGC -> TCGAGTTACCGACAAAAGCG
CTCGATAATGTCTACGATCA -> TCGATAATGTCTACGATCAC
CTCGCATACCGCCATAGCGA -> TCGCATACCGCCATAGCGAC
CTCGCGCCGAAGGACATGCG -> TCGCGCCGAAGGACATGCGA
CTCGCGCGGGGAGGGATGGT -> TCGCGCGGGGAGGGATGGTT
CTCGTCGCAGTGCGATTGCT -> TCGTCGCAGTGCGATTGCTT
CTCGTCTTACCATAGATGTT -> TCGTCTTACCATAGATGTTC
CTCGTGGGATACACTTCGAG -> TCGTGGGATACACTTCGAGC
CTCTCAAACACCGTAAATAT -> TCTCAAACACCGTAAATATG
CTCTCATGGCTGCTACCGCA -> TCTCATGGCTGCTACCGCAA
CTCTCGAGCGGGGTTGCAGG -> TCTCGAGCGGGGTTGCAGGG
CTCTGCAGTAATCAGCGTTG -> TCTGCAGTAATCAGCGTTGT
CTCTTAATTTGTACATCGTG -> TCTTAATTTGTACATCGTGG
CTCTTTTAATCTTCGAATTC -> TCTTTTAATCTTCGAATTCA
CTGACACAGACTCCGATTCA -> TGACACAGACTCCGATTCAA
CTGACATCACACGGTAGCAG -> TGACATCACACGGTAGCAGA
CTGACGACCGATAAGCTCCC -> TGACGACCGATAAGCTCCCA
CTGACGCGATCTGGTCAAAC -> TGACGCGATCTGGTCAAACG
CTGACTTGTAGCCTAAGGAG -> TGACTTGTAGCCTAAGGAGG
CTGATGGCATTTACCCCGAA -> TGATGGCATTTACCCCGAAA
CTGATTTTCAACGGGCTAAA -> TGATTTTCAACGGGCTAAAA
CTGCAACATACTATATCCGT -> TGCAACATACTATATCCGTG
CTGCAATCTTAAAGGGCATG -> TGCAATCTTAAAGGGCATGC
CTGCAGTAATCAGCGTTGTA -> TGCAGTAATCAGCGTTGTAA
CTGCATTCCCATTGTCTTGC -> TGCATTCCCATTGTCTTGCC
CTGCCTACGTTTGCACTATG -> TGCCTACGTTTGCACTATGA
CTGCTACCGCAACGCAGGAC -> TGCTACCGCAACGCAGGACT
CTGCTTGCGATGTGTATCGG -> TGCTTGCGATGTGTATCGGC
CTGCTTTTGTCGACATGACA -> TGCTTTTGTCGACATGACAC
CTGGTAGTAGTACTCTCATG -> TGGTAGTAGTACTCTCATGG
CTGGTCAAACGAAGAATCAC -> TGGTCAAACGAAGAATCACA
CTGGTTATTGTTATGCCCGC -> TGGTTATTGTTATGCCCGCT
CTGTGCTTGTTTTCGAAGAG -> TGTGCTTGTTTTCGAAGAGG
CTGTTCAGCCCACATGAGCG -> TGTTCAGCCCACATGAGCGA
CTGTTGCGATGAGTTTGTCG -> TGTTGCGATGAGTTTGTCGA
CTGTTTTACTCGTGGGATAC -> TGTTTTACTCGTGGGATACA
CTTAAAGGGCATGCGTACGA -> TTAAAGGGCATGCGTACGAG
CTTAATTTGTACATCGTGGC -> TTAATTTGTACATCGTGGCT
CTTACAAACCTGACACAGAC -> TTACAAACCTGACACAGACT
CTTACACACCGACTGGTTAT -> TTACACACCGACTGGTTATT
CTTACCATAGATGTTCGGTT -> TTACCATAGATGTTCGGTTG
CTTACCTGCTTGCGATGTGT -> TTACCTGCTTGCGATGTGTA
CTTAGGCACCGCGCCTCTCG -> TTAGGCACCGCGCCTCTCGA
CTTAGGCATCAGTGTTATGG -> TTAGGCATCAGTGTTATGGA
CTTAGTGGACTAAATACAGG -> TTAGTGGACTAAATACAGGA
CTTATACACCAGCACTAGGT -> TTATACACCAGCACTAGGTG
CTTATCAGGGGTTCGCCTAA -> TTATCAGGGGTTCGCCTAAT
CTTATCAGTCTCGAGTTACC -> TTATCAGTCTCGAGTTACCG
CTTATCGGAACATAGTGGAA -> TTATCGGAACATAGTGGAAG
CTTCCCATAACAGTAAAATT -> TTCCCATAACAGTAAAATTT
CTTCCGCCCCGCTACATTCG -> TTCCGCCCCGCTACATTCGC
CTTCGAATTCAACGCTATTG -> TTCGAATTCAACGCTATTGC
CTTCGAGCTGCCTACGTTTG -> TTCGAGCTGCCTACGTTTGC
CTTCGCTTTCAGAGTGTTAA -> TTCGCTTTCAGAGTGTTAAG
CTTCTCAGCCTTATCAGTCT -> TTCTCAGCCTTATCAGTCTC
CTTCTGGTAGTAGTACTCTC -> TTCTGGTAGTAGTACTCTCA
CTTGAATTACTAATCCATTT -> TTGAATTACTAATCCATTTT
CTTGACTCCTTAGGCATCAG -> TTGACTCCTTAGGCATCAGT
CTTGATCTTCTGGTAGTAGT -> TTGATCTTCTGGTAGTAGTA
CTTGCCGCTTTATCAGTTGA -> TTGCCGCTTTATCAGTTGAC
CTTGCGATGTGTATCGGCAT -> TTGCGATGTGTATCGGCATT
CTTGTAGCCTAAGGAGGGTG -> TTGTAGCCTAAGGAGGGTGC
CTTGTCTGTTCAGCCCACAT -> TTGTCTGTTCAGCCCACATG
CTTGTTTTCGAAGAGGCCCT -> TTGTTTTCGAAGAGGCCCTT
CTTTAAACGGTGTTCTCTGC -> TTTAAACGGTGTTCTCTGCA
CTTTAAATGACATAACGTCC -> TTTAAATGACATAACGTCCC
CTTTATCAGTTGACCCTCCG -> TTTATCAGTTGACCCTCCGC
CTTTCAGAGTGTTAAGGACC -> TTTCAGAGTGTTAAGGACCG
CTTTCCGTCGCTACTTACAA -> TTTCCGTCGCTACTTACAAA
CTTTGTCGACATGACACCGC -> TTTGTCGACATGACACCGCT
CTTTTAATCTTCGAATTCAA -> TTTTAATCTTCGAATTCAAC
CTTTTCCTATCACAGGGGAA -> TTTTCCTATCACAGGGGAAT
CTTTTGACAACTTTTCCTAT -> TTTTGACAACTTTTCCTATC
CTTTTGTCGACATGACACCG -> TTTTGTCGACATGACACCGT
GAAACATTGGCGTCGCATAA -> AAACATTGGCGTCGCATAAC
GAAACTGACTTGTAGCCTAA -> AAACTGACTTGTAGCCTAAG
GAAAGACCTCGCGCCGAAGG -> AAAGACCTCGCGCCGAAGGA
GAAATATATTAATTCCCAAC -> AAATATATTAATTCCCAACA
GAAATCACGTGAACCGGCTG -> AAATCACGTGAACCGGCTGA
GAAATCCGAAGAAGTTGTGA -> AAATCCGAAGAAGTTGTGAA
GAAATCTACTTATACACCAG -> AAATCTACTTATACACCAGC
GAAATGCTATGCTGATTTTC -> AAATGCTATGCTGATTTTCA
GAACAGCGGGTGTCGCTACC -> AACAGCGGGTGTCGCTACCG
GAACAGGAATTACTACGAGT -> AACAGGAATTACTACGAGTG
GAACATAGTGGAAGCTGCAA -> AACATAGTGGAAGCTGCAAC
GAACCGCATGTTATTCTACT -> AACCGCATGTTATTCTACTC
GAACCGGCTGACGACCGATA -> AACCGGCTGACGACCGATAA
GAACCTAAGTCCCCGGGGTG -> AACCTAAGTCCCCGGGGTGA
GAACCTGATGGCATTTACCC -> AACCTGATGGCATTTACCCC
GAACTTTCCGTCGCTACTTA -> AACTTTCCGTCGCTACTTAC
GAAGAAGTTGTGAAGTCAAA -> AAGAAGTTGTGAAGTCAAAC
GAAGAATCACATTGACAGAG -> AAGAATCACATTGACAGAGT
GAAGACTTGAATTACTAATC -> AAGACTTGAATTACTAATCC
GAAGAGGCCCTTCTCAGCCT -> AAGAGGCCCTTCTCAGCCTT
GAAGAGGGATCGCCCTGACG -> AAGAGGGATCGCCCTGACGC
GAAGCTGCAACATACTATAT -> AAGCTGCAACATACTATATC
GAAGGACATGCGATACCATA -> AAGGACATGCGATACCATAA
GAAGGCAGCTACTCAAGTCA -> AAGGCAGCTACTCAAGTCAC
GAAGTCAAACTAAAAATCAC -> AAGTCAAACTAAAAATCACG
GAAGTCAAACTAACGAATAA -> AAGTCAAACTAACGAATAAT
GAAGTCAAACTAAGAATATC -> AAGTCAAACTAAGAATATCA
GAAGTCAAACTAAGCCAAAT -> AAGTCAAACTAAGCCAAATT
GAAGTTGTGAAGTCAAACTA -> AAGTTGTGAAGTCAAACTAA
GAATAATCGAGAGTCATCCT -> AATAATCGAGAGTCATCCTC
GAATATCACCCCGGCGTCAT -> AATATCACCCCGGCGTCATC
GAATCACATTGACAGAGTAG -> AATCACATTGACAGAGTAGC
GAATCCGGACGCAAGAGTTG -> AATCCGGACGCAAGAGTTGC
GAATCCTCGTCGCAGTGCGA -> AATCCTCGTCGCAGTGCGAT
GAATTACTAATCCATTTTAT -> AATTACTAATCCATTTTATT
GAATTACTACGAGTGAAGGC -> AATTACTACGAGTGAAGGCA
GAATTCAACGCTATTGCCTG -> AATTCAACGCTATTGCCTGT
GACAAAAGCGTGGCCGGTAA -> ACAAAAGCGTGGCCGGTAAT
GACAACTTTTCCTATCACAG -> ACAACTTTTCCTATCACAGG
GACACAGACTCCGATTCAAT -> ACACAGACTCCGATTCAATC
GACACCGAAATCCGAAGAAG -> ACACCGAAATCCGAAGAAGT
GACACCGCTCGACAGCCTAG -> ACACCGCTCGACAGCCTAGT
GACACCGGCAAAGAGTTTAG -> ACACCGGCAAAGAGTTTAGT
GACACCGTTGCCGCCGTTAG -> ACACCGTTGCCGCCGTTAGT
GACAGAGTAGCTTTAAACGG -> ACAGAGTAGCTTTAAACGGT
GACAGCCTAGTTGTGAAGTC -> ACAGCCTAGTTGTGAAGTCA
GACATAACGTCCCAGCCTCT -> ACATAACGTCCCAGCCTCTT
GACATCACACGGTAGCAGAC -> ACATCACACGGTAGCAGACG
GACATGACACCGAAATCCGA -> ACATGACACCGAAATCCGAA
GACATGACACCGCTCGACAG -> ACATGACACCGCTCGACAGC
GACATGACACCGGCAAAGAG -> ACATGACACCGGCAAAGAGT
GACATGACACCGTTGCCGCC -> ACATGACACCGTTGCCGCCG
GACATGCGATACCATAACCT -> ACATGCGATACCATAACCTT
GACCCCTAGTTGTACAAGCA -> ACCCCTAGTTGTACAAGCAG
GACCCTCCGCGCGTTCGCAT -> ACCCTCCGCGCGTTCGCATA
GACCGATAAGCTCCCACAGT -> ACCGATAAGCTCCCACAGTA
GACCGTGAGTATGGTTAATA -> ACCGTGAGTATGGTTAATAT
GACCTCGCGCCGAAGGACAT -> ACCTCGCGCCGAAGGACATG
GACCTTTGTCGACATGACAC -> ACCTTTGTCGACATGACACC
GACGAAATGCTATGCTGATT -> ACGAAATGCTATGCTGATTT
GACGACCGATAAGCTCCCAC -> ACGACCGATAAGCTCCCACA
GACGCAAGAGTTGCCGACGA -> ACGCAAGAGTTGCCGACGAA
GACGCGATCTGGTCAAACGA -> ACGCGATCTGGTCAAACGAA
GACGCTTATCGGAACATAGT -> ACGCTTATCGGAACATAGTG
GACGGATACATTACATGTAA -> ACGGATACATTACATGTAAG
GACGGATCCATCCCTTAGGC -> ACGGATCCATCCCTTAGGCA
GACGGCTTACCTGCTTGCGA -> ACGGCTTACCTGCTTGCGAT
GACGTAATAATGCAACCTAG -> ACGTAATAATGCAACCTAGA
GACTAAATACAGGATAGAGG -> ACTAAATACAGGATAGAGGG
GACTATTCTGACATCACACG -> ACTATTCTGACATCACACGG
GACTCCGATTCAATCTACAT -> ACTCCGATTCAATCTACATC
GACTCCTTAGGCATCAGTGT -> ACTCCTTAGGCATCAGTGTT
GACTGGTTATTGTTATGCCC -> ACTGGTTATTGTTATGCCCG
GACTTGAATTACTAATCCAT -> ACTTGAATTACTAATCCATT
GACTTGTAGCCTAAGGAGGG -> ACTTGTAGCCTAAGGAGGGT
GACTTGTCTGTTCAGCCCAC -> ACTTGTCTGTTCAGCCCACA
GAGAACCTAAGTCCCCGGGG -> AGAACCTAAGTCCCCGGGGT
GAGAGTCATCCTCAGTTTAT -> AGAGTCATCCTCAGTTTATA
GAGAGTCGCCAGTCAGGAAA -> AGAGTCGCCAGTCAGGAAAC
GAGCGACGCTTATCGGAACA -> AGCGACGCTTATCGGAACAT
GAGCGGGGTTGCAGGGCTGT -> AGCGGGGTTGCAGGGCTGTT
GAGCGGTGAGAACCTAAGTC -> AGCGGTGAGAACCTAAGTCC
GAGCTCGCATACCGCCATAG -> AGCTCGCATACCGCCATAGC
GAGCTGCCTACGTTTGCACT -> AGCTGCCTACGTTTGCACTA
GAGGCATTGATTATGTTTCG -> AGGCATTGATTATGTTTCGT
GAGGCCCTTCTCAGCCTTAT -> AGGCCCTTCTCAGCCTTATC
GAGGGATCGCCCTGACGCGA -> AGGGATCGCCCTGACGCGAT
GAGGGATGGTTTTTACTCCT -> AGGGATGGTTTTTACTCCTC
GAGGGCGCTACAAGTGATGT -> AGGGCGCTACAAGTGATGTT
GAGGGTGCCCTACGGCTCCT -> AGGGTGCCCTACGGCTCCTA
GAGGTGGATGGCATCGTGTT -> AGGTGGATGGCATCGTGTTC
GAGGTTCCCGGAAATATATT -> AGGTTCCCGGAAATATATTA
GAGTAACCGGGTATATCTGT -> AGTAACCGGGTATATCTGTT
GAGTAGCTTTAAACGGTGTT -> AGTAGCTTTAAACGGTGTTC
GAGTATGGTTAATATAACGA -> AGTATGGTTAATATAACGAA
GAGTCATCCTCAGTTTATAC -> AGTCATCCTCAGTTTATACG
GAGTCGCCAGTCAGGAAACT -> AGTCGCCAGTCAGGAAACTG
GAGTGAACCGCATGTTATTC -> AGTGAACCGCATGTTATTCT
GAGTGAAGGCAGCTACTCAA -> AGTGAAGGCAGCTACTCAAG
GAGTGTTAAGGACCGTGAGT -> AGTGTTAAGGACCGTGAGTA
GAGTTACCGACAAAAGCGTG -> AGTTACCGACAAAAGCGTGG
GAGTTGCCGACGAAATGCTA -> AGTTGCCGACGAAATGCTAT
GAGTTTAGTTGTGAAGTCAA -> AGTTTAGTTGTGAAGTCAAA
GAGTTTGTCGACATGACACC -> AGTTTGTCGACATGACACCG
GATAAGCTCCCACAGTACAG -> ATAAGCTCCCACAGTACAGC
GATAATGTCTACGATCACGC -> ATAATGTCTACGATCACGCG
GATACACTTCGAGCTGCCTA -> ATACACTTCGAGCTGCCTAC
GATACATTACATGTAAGGCT -> ATACATTACATGTAAGGCTC
GATACCATAACCTTGACTCC -> ATACCATAACCTTGACTCCT
GATAGAGGGCGCTACAAGTG -> ATAGAGGGCGCTACAAGTGA
GATCACGCGAGTAACCGGGT -> ATCACGCGAGTAACCGGGTA
GATCCATCCCTTAGGCACCG -> ATCCATCCCTTAGGCACCGC
GATCCGCAATCTTATCAGGG -> ATCCGCAATCTTATCAGGGG
GATCGCCCTGACGCGATCTG -> ATCGCCCTGACGCGATCTGG
GATCTGGTCAAACGAAGAAT -> ATCTGGTCAAACGAAGAATC
GATCTTCTGGTAGTAGTACT -> ATCTTCTGGTAGTAGTACTC
GATGACGGATACATTACATG -> ATGACGGATACATTACATGT
GATGAGTTTGTCGACATGAC -> ATGAGTTTGTCGACATGACA
GATGCAGTAGGTGGTGCGTT -> ATGCAGTAGGTGGTGCGTTT
GATGGCATCGTGTTCCTATG -> ATGGCATCGTGTTCCTATGA
GATGGCATTTACCCCGAAAT -> ATGGCATTTACCCCGAAATC
GATGGTTTTTACTCCTCACA -> ATGGTTTTTACTCCTCACAC
GATGTGTATCGGCATTTTCC -> ATGTGTATCGGCATTTTCCG
GATGTTCGGTTGCCACAGGT -> ATGTTCGGTTGCCACAGGTG
GATGTTCTTCCGCCCCGCTA -> ATGTTCTTCCGCCCCGCTAC
GATTATGTTTCGTAATTAAA -> ATTATGTTTCGTAATTAAAC
GATTCAATCTACATCGAACA -> ATTCAATCTACATCGAACAG
GATTCGGACCCCTAGTTGTA -> ATTCGGACCCCTAGTTGTAC
GATTGCTTTAAATGACATAA -> ATTGCTTTAAATGACATAAC
GATTTTCAACGGGCTAAAAC -> ATTTTCAACGGGCTAAAACG
GCAAAGAGTTTAGTTGTGAA -> CAAAGAGTTTAGTTGTGAAG
GCAACATACTATATCCGTGT -> CAACATACTATATCCGTGTA
GCAACCTAGAACTTTCCGTC -> CAACCTAGAACTTTCCGTCG
GCAACGCAGGACTTGTCTGT -> CAACGCAGGACTTGTCTGTT
GCAACTTACACACCGACTGG -> CAACTTACACACCGACTGGT
GCAAGAGTTGCCGACGAAAT -> CAAGAGTTGCCGACGAAATG
GCAAGGTGAAGAGGGATCGC -> CAAGGTGAAGAGGGATCGCC
GCAATCTTAAAGGGCATGCG -> CAATCTTAAAGGGCATGCGT
GCAATCTTATCAGGGGTTCG -> CAATCTTATCAGGGGTTCGC
GCACCGCGCCTCTCGAGCGG -> CACCGCGCCTCTCGAGCGGG
GCACGGTTTAACCGCAAGGT -> CACGGTTTAACCGCAAGGTG
GCACTAGGTGGAGCGGTGAG -> CACTAGGTGGAGCGGTGAGA
GCACTATGAAACATTGGCGT -> CACTATGAAACATTGGCGTC
GCAGACGGATCCATCCCTTA -> CAGACGGATCCATCCCTTAG
GCAGCTACTCAAGTCACTTC -> CAGCTACTCAAGTCACTTCC
GCAGGACTTGTCTGTTCAGC -> CAGGACTTGTCTGTTCAGCC
GCAGGCATACCTAGACGGCT -> CAGGCATACCTAGACGGCTT
GCAGGGCCAGTGAACCTGAT -> CAGGGCCAGTGAACCTGATG
GCAGGGCTGTTTTACTCGTG -> CAGGGCTGTTTTACTCGTGG
GCAGGGGGTTGCGGATGCAG -> CAGGGGGTTGCGGATGCAGT
GCAGTAATCAGCGTTGTAAC -> CAGTAATCAGCGTTGTAACA
GCAGTAGGTGGTGCGTTTTC -> CAGTAGGTGGTGCGTTTTCG
GCAGTGCGATTGCTTTAAAT -> CAGTGCGATTGCTTTAAATG
GCATAACATTTGTCGACATG -> CATAACATTTGTCGACATGA
GCATAAGTATGCCTATACTC -> CATAAGTATGCCTATACTCT
GCATACCGCCATAGCGACCT -> CATACCGCCATAGCGACCTT
GCATACCTAGACGGCTTACC -> CATACCTAGACGGCTTACCT
GCATATGTACAGCGGTGGAC -> CATATGTACAGCGGTGGACG
GCATCAGTGTTATGGAGCTC -> CATCAGTGTTATGGAGCTCG
GCATCGTGTTCCTATGAATC -> CATCGTGTTCCTATGAATCC
GCATGAGTGAACCGCATGTT -> CATGAGTGAACCGCATGTTA
GCATGCGTACGAGGTGGATG -> CATGCGTACGAGGTGGATGG
GCATGGAGGTTCCCGGAAAT -> CATGGAGGTTCCCGGAAATA
GCATGTTATTCTACTCTCAA -> CATGTTATTCTACTCTCAAA
GCATTCCCATTGTCTTGCCG -> CATTCCCATTGTCTTGCCGC
GCATTGATTATGTTTCGTAA -> CATTGATTATGTTTCGTAAT
GCATTTACCCCGAAATCTAC -> CATTTACCCCGAAATCTACT
GCATTTTCCGTACACCGCTG -> CATTTTCCGTACACCGCTGC
GCCAAATTTATTTGATTCGG -> CCAAATTTATTTGATTCGGA
GCCACAGGTGGTAGCAACTT -> CCACAGGTGGTAGCAACTTA
GCCAGTCAGGAAACTGACTT -> CCAGTCAGGAAACTGACTTG
GCCAGTGAACCTGATGGCAT -> CCAGTGAACCTGATGGCATT
GCCATAGCGACCTTTGTCGA -> CCATAGCGACCTTTGTCGAC
GCCCACATGAGCGACGCTTA -> CCCACATGAGCGACGCTTAT
GCCCCGCTACATTCGCGCAG -> CCCCGCTACATTCGCGCAGG
GCCCGCTAGGGCATGGAGGT -> CCCGCTAGGGCATGGAGGTT
GCCCTACGGCTCCTAGCATA -> CCCTACGGCTCCTAGCATAT
GCCCTGACGCGATCTGGTCA -> CCCTGACGCGATCTGGTCAA
GCCCTTCTCAGCCTTATCAG -> CCCTTCTCAGCCTTATCAGT
GCCGAAGGACATGCGATACC -> CCGAAGGACATGCGATACCA
GCCGACGAAATGCTATGCTG -> CCGACGAAATGCTATGCTGA
GCCGCCGTTAGTTGTGAAGT -> CCGCCGTTAGTTGTGAAGTC
GCCGCTTTATCAGTTGACCC -> CCGCTTTATCAGTTGACCCT
GCCGGTAATTGTCGGGCATG -> CCGGTAATTGTCGGGCATGA
GCCGGTACCTCCCTAGCTAT -> CCGGTACCTCCCTAGCTATA
GCCGTTAGTTGTGAAGTCAA -> CCGTTAGTTGTGAAGTCAAA
GCCTAAGGAGGGTGCCCTAC -> CCTAAGGAGGGTGCCCTACG
GCCTAATGAGAGTCGCCAGT -> CCTAATGAGAGTCGCCAGTC
GCCTACGTTTGCACTATGAA -> CCTACGTTTGCACTATGAAA
GCCTAGTTGTGAAGTCAAAC -> CCTAGTTGTGAAGTCAAACT
GCCTATACTCTTTTAATCTT -> CCTATACTCTTTTAATCTTC
GCCTCTCGAGCGGGGTTGCA -> CCTCTCGAGCGGGGTTGCAG
GCCTCTTAATTTGTACATCG -> CCTCTTAATTTGTACATCGT
GCCTGTGCTTGTTTTCGAAG -> CCTGTGCTTGTTTTCGAAGA
GCCTTATCAGTCTCGAGTTA -> CCTTATCAGTCTCGAGTTAC
GCGACCTTTGTCGACATGAC -> CGACCTTTGTCGACATGACA
GCGACGCTTATCGGAACATA -> CGACGCTTATCGGAACATAG
GCGAGTAACCGGGTATATCT -> CGAGTAACCGGGTATATCTG
GCGATACCATAACCTTGACT -> CGATACCATAACCTTGACTC
GCGATCTGGTCAAACGAAGA -> CGATCTGGTCAAACGAAGAA
GCGATGACGGATACATTACA -> CGATGACGGATACATTACAT
GCGATGAGTTTGTCGACATG -> CGATGAGTTTGTCGACATGA
GCGATGTGTATCGGCATTTT -> CGATGTGTATCGGCATTTTC
GCGATTGCTTTAAATGACAT -> CGATTGCTTTAAATGACATA
GCGCAGGGCCAGTGAACCTG -> CGCAGGGCCAGTGAACCTGA
GCGCCGAAGGACATGCGATA -> CGCCGAAGGACATGCGATAC
GCGCCTCTCGAGCGGGGTTG -> CGCCTCTCGAGCGGGGTTGC
GCGCGGGGAGGGATGGTTTT -> CGCGGGGAGGGATGGTTTTT
GCGCGTTCGCATAAGTATGC -> CGCGTTCGCATAAGTATGCC
GCGCTACAAGTGATGTTCTT -> CGCTACAAGTGATGTTCTTC
GCGGATGCAGTAGGTGGTGC -> CGGATGCAGTAGGTGGTGCG
GCGGCACGGTTTAACCGCAA -> CGGCACGGTTTAACCGCAAG
GCGGGGAGGGATGGTTTTTA -> CGGGGAGGGATGGTTTTTAC
GCGGGGTCAGTTGCTGCATT -> CGGGGTCAGTTGCTGCATTC
GCGGGGTTGCAGGGCTGTTT -> CGGGGTTGCAGGGCTGTTTT
GCGGGTGTCGCTACCGTACC -> CGGGTGTCGCTACCGTACCG
GCGGTGAGAACCTAAGTCCC -> CGGTGAGAACCTAAGTCCCC
GCGGTGGACGTAATAATGCA -> CGGTGGACGTAATAATGCAA
GCGTAAGTAATGACTATTCT -> CGTAAGTAATGACTATTCTG
GCGTACGAGGTGGATGGCAT -> CGTACGAGGTGGATGGCATC
GCGTCATCTAGCAGGCATAC -> CGTCATCTAGCAGGCATACC
GCGTCGCATAACATTTGTCG -> CGTCGCATAACATTTGTCGA
GCGTGGCCGGTAATTGTCGG -> CGTGGCCGGTAATTGTCGGG
GCGTTCGCATAAGTATGCCT -> CGTTCGCATAAGTATGCCTA
GCGTTGTAACACCCTCGCGC -> CGTTGTAACACCCTCGCGCG
GCGTTTTCGCTTGATCTTCT -> CGTTTTCGCTTGATCTTCTG
GCTAAAACGTCTTTTGACAA -> CTAAAACGTCTTTTGACAAC
GCTAAGCGATGACGGATACA -> CTAAGCGATGACGGATACAT
GCTACAAGTGATGTTCTTCC -> CTACAAGTGATGTTCTTCCG
GCTACATTCGCGCAGGGCCA -> CTACATTCGCGCAGGGCCAG
GCTACCGCAACGCAGGACTT -> CTACCGCAACGCAGGACTTG
GCTACCGTACCGTCTATTGC -> CTACCGTACCGTCTATTGCG
GCTACTCAAGTCACTTCCCA -> CTACTCAAGTCACTTCCCAT
GCTACTTACAAACCTGACAC -> CTACTTACAAACCTGACACA
GCTAGGGCATGGAGGTTCCC -> CTAGGGCATGGAGGTTCCCG
GCTATACGGGAAAGACCTCG -> CTATACGGGAAAGACCTCGC
GCTATGCTGATTTTCAACGG -> CTATGCTGATTTTCAACGGG
GCTATTGCCTGTGCTTGTTT -> CTATTGCCTGTGCTTGTTTT
GCTCCCACAGTACAGCGGGG -> CTCCCACAGTACAGCGGGGT
GCTCCTAGCATATGTACAGC -> CTCCTAGCATATGTACAGCG
GCTCGACAGCCTAGTTGTGA -> CTCGACAGCCTAGTTGTGAA
GCTCGATAATGTCTACGATC -> CTCGATAATGTCTACGATCA
GCTCGCATACCGCCATAGCG -> CTCGCATACCGCCATAGCGA
GCTCGTCTTACCATAGATGT -> CTCGTCTTACCATAGATGTT
GCTGACGACCGATAAGCTCC -> CTGACGACCGATAAGCTCCC
GCTGATTTTCAACGGGCTAA -> CTGATTTTCAACGGGCTAAA
GCTGCAACATACTATATCCG -> CTGCAACATACTATATCCGT
GCTGCAATCTTAAAGGGCAT -> CTGCAATCTTAAAGGGCATG
GCTGCATTCCCATTGTCTTG -> CTGCATTCCCATTGTCTTGC
GCTGCCTACGTTTGCACTAT -> CTGCCTACGTTTGCACTATG
GCTGCTACCGCAACGCAGGA -> CTGCTACCGCAACGCAGGAC
GCTGCTTTTGTCGACATGAC -> CTGCTTTTGTCGACATGACA
GCTGTTTTACTCGTGGGATA -> CTGTTTTACTCGTGGGATAC
GCTTACCTGCTTGCGATGTG -> CTTACCTGCTTGCGATGTGT
GCTTATCGGAACATAGTGGA -> CTTATCGGAACATAGTGGAA
GCTTGATCTTCTGGTAGTAG -> CTTGATCTTCTGGTAGTAGT
GCTTGCGATGTGTATCGGCA -> CTTGCGATGTGTATCGGCAT
GCTTGTTTTCGAAGAGGCCC -> CTTGTTTTCGAAGAGGCCCT
GCTTTAAACGGTGTTCTCTG -> CTTTAAACGGTGTTCTCTGC
GCTTTAAATGACATAACGTC -> CTTTAAATGACATAACGTCC
GCTTTATCAGTTGACCCTCC -> CTTTATCAGTTGACCCTCCG
GCTTTCAGAGTGTTAAGGAC -> CTTTCAGAGTGTTAAGGACC
GCTTTTGTCGACATGACACC -> CTTTTGTCGACATGACACCG
GGAAACTGACTTGTAGCCTA -> GAAACTGACTTGTAGCCTAA
GGAAAGACCTCGCGCCGAAG -> GAAAGACCTCGCGCCGAAGG
GGAAATATATTAATTCCCAA -> GAAATATATTAATTCCCAAC
GGAAATCACGTGAACCGGCT -> GAAATCACGTGAACCGGCTG
GGAACATAGTGGAAGCTGCA -> GAACATAGTGGAAGCTGCAA
GGAAGCTGCAACATACTATA -> GAAGCTGCAACATACTATAT
GGAATCCTCGTCGCAGTGCG -> GAATCCTCGTCGCAGTGCGA
GGAATTACTACGAGTGAAGG -> GAATTACTACGAGTGAAGGC
GGACATGCGATACCATAACC -> GACATGCGATACCATAACCT
GGACCCCTAGTTGTACAAGC -> GACCCCTAGTTGTACAAGCA
GGACCGTGAGTATGGTTAAT -> GACCGTGAGTATGGTTAATA
GGACGCAAGAGTTGCCGACG -> GACGCAAGAGTTGCCGACGA
GGACGTAATAATGCAACCTA -> GACGTAATAATGCAACCTAG
GGACTAAATACAGGATAGAG -> GACTAAATACAGGATAGAGG
GGACTTGTCTGTTCAGCCCA -> GACTTGTCTGTTCAGCCCAC
GGAGCGGTGAGAACCTAAGT -> GAGCGGTGAGAACCTAAGTC
GGAGCTCGCATACCGCCATA -> GAGCTCGCATACCGCCATAG
GGAGGGATGGTTTTTACTCC -> GAGGGATGGTTTTTACTCCT
GGAGGGTGCCCTACGGCTCC -> GAGGGTGCCCTACGGCTCCT
GGAGGTTCCCGGAAATATAT -> GAGGTTCCCGGAAATATATT
GGATACACTTCGAGCTGCCT -> GATACACTTCGAGCTGCCTA
GGATACATTACATGTAAGGC -> GATACATTACATGTAAGGCT
GGATAGAGGGCGCTACAAGT -> GATAGAGGGCGCTACAAGTG
GGATCCATCCCTTAGGCACC -> GATCCATCCCTTAGGCACCG
GGATCGCCCTGACGCGATCT -> GATCGCCCTGACGCGATCTG
GGATGCAGTAGGTGGTGCGT -> GATGCAGTAGGTGGTGCGTT
GGATGGCATCGTGTTCCTAT -> GATGGCATCGTGTTCCTATG
GGATGGTTTTTACTCCTCAC -> GATGGTTTTTACTCCTCACA
GGCAAAGAGTTTAGTTGTGA -> GCAAAGAGTTTAGTTGTGAA
GGCACCGCGCCTCTCGAGCG -> GCACCGCGCCTCTCGAGCGG
GGCACGGTTTAACCGCAAGG -> GCACGGTTTAACCGCAAGGT
GGCAGCTACTCAAGTCACTT -> GCAGCTACTCAAGTCACTTC
GGCATACCTAGACGGCTTAC -> GCATACCTAGACGGCTTACC
GGCATCAGTGTTATGGAGCT -> GCATCAGTGTTATGGAGCTC
GGCATCGTGTTCCTATGAAT -> GCATCGTGTTCCTATGAATC
GGCATGAGTGAACCGCATGT -> GCATGAGTGAACCGCATGTT
GGCATGCGTACGAGGTGGAT -> GCATGCGTACGAGGTGGATG
GGCATGGAGGTTCCCGGAAA -> GCATGGAGGTTCCCGGAAAT
GGCATTGATTATGTTTCGTA -> GCATTGATTATGTTTCGTAA
GGCATTTACCCCGAAATCTA -> GCATTTACCCCGAAATCTAC
GGCATTTTCCGTACACCGCT -> GCATTTTCCGTACACCGCTG
GGCCAGTGAACCTGATGGCA -> GCCAGTGAACCTGATGGCAT
GGCCCTTCTCAGCCTTATCA -> GCCCTTCTCAGCCTTATCAG
GGCCGGTAATTGTCGGGCAT -> GCCGGTAATTGTCGGGCATG
GGCGCTACAAGTGATGTTCT -> GCGCTACAAGTGATGTTCTT
GGCGTAAGTAATGACTATTC -> GCGTAAGTAATGACTATTCT
GGCGTCATCTAGCAGGCATA -> GCGTCATCTAGCAGGCATAC
GGCGTCGCATAACATTTGTC -> GCGTCGCATAACATTTGTCG
GGCTAAAACGTCTTTTGACA -> GCTAAAACGTCTTTTGACAA
GGCTCCTAGCATATGTACAG -> GCTCCTAGCATATGTACAGC
GGCTCGATAATGTCTACGAT -> GCTCGATAATGTCTACGATC
GGCTCGTCTTACCATAGATG -> GCTCGTCTTACCATAGATGT
GGCTGACGACCGATAAGCTC -> GCTGACGACCGATAAGCTCC
GGCTGCTACCGCAACGCAGG -> GCTGCTACCGCAACGCAGGA
GGCTGTTTTACTCGTGGGAT -> GCTGTTTTACTCGTGGGATA
GGCTTACCTGCTTGCGATGT -> GCTTACCTGCTTGCGATGTG
GGGAAAGACCTCGCGCCGAA -> GGAAAGACCTCGCGCCGAAG
GGGAAATCACGTGAACCGGC -> GGAAATCACGTGAACCGGCT
GGGAATCCTCGTCGCAGTGC -> GGAATCCTCGTCGCAGTGCG
GGGAGGGATGGTTTTTACTC -> GGAGGGATGGTTTTTACTCC
GGGATACACTTCGAGCTGCC -> GGATACACTTCGAGCTGCCT
GGGATCGCCCTGACGCGATC -> GGATCGCCCTGACGCGATCT
GGGATGGTTTTTACTCCTCA -> GGATGGTTTTTACTCCTCAC
GGGCATGAGTGAACCGCATG -> GGCATGAGTGAACCGCATGT
GGGCATGCGTACGAGGTGGA -> GGCATGCGTACGAGGTGGAT
GGGCATGGAGGTTCCCGGAA -> GGCATGGAGGTTCCCGGAAA
GGGCCAGTGAACCTGATGGC -> GGCCAGTGAACCTGATGGCA
GGGCGCTACAAGTGATGTTC -> GGCGCTACAAGTGATGTTCT
GGGCGTAAGTAATGACTATT -> GGCGTAAGTAATGACTATTC
GGGCTAAAACGTCTTTTGAC -> GGCTAAAACGTCTTTTGACA
GGGCTGTTTTACTCGTGGGA -> GGCTGTTTTACTCGTGGGAT
GGGGAAATCACGTGAACCGG -> GGGAAATCACGTGAACCGGC
GGGGAATCCTCGTCGCAGTG -> GGGAATCCTCGTCGCAGTGC
GGGGAGGGATGGTTTTTACT -> GGGAGGGATGGTTTTTACTC
GGGGGTTGCGGATGCAGTAG -> GGGGTTGCGGATGCAGTAGG
GGGGTCAGTTGCTGCATTCC -> GGGTCAGTTGCTGCATTCCC
GGGGTGAACAGCGGGTGTCG -> GGGTGAACAGCGGGTGTCGC
GGGGTTCGCCTAATGAGAGT -> GGGTTCGCCTAATGAGAGTC
GGGGTTGCAGGGCTGTTTTA -> GGGTTGCAGGGCTGTTTTAC
GGGGTTGCGGATGCAGTAGG -> GGGTTGCGGATGCAGTAGGT
GGGTATATCTGTTGCGATGA -> GGTATATCTGTTGCGATGAG
GGGTCAGTTGCTGCATTCCC -> GGTCAGTTGCTGCATTCCCA
GGGTGAACAGCGGGTGTCGC -> GGTGAACAGCGGGTGTCGCT
GGGTGCCCTACGGCTCCTAG -> GGTGCCCTACGGCTCCTAGC
GGGTGTCGCTACCGTACCGT -> GGTGTCGCTACCGTACCGTC
GGGTTCGCCTAATGAGAGTC -> GGTTCGCCTAATGAGAGTCG
GGGTTGCAGGGCTGTTTTAC -> GGTTGCAGGGCTGTTTTACT
GGGTTGCGGATGCAGTAGGT -> GGTTGCGGATGCAGTAGGTG
GGTAATTGTCGGGCATGAGT -> GTAATTGTCGGGCATGAGTG
GGTACCGTGCCGGTACCTCC -> GTACCGTGCCGGTACCTCCC
GGTACCTCCCTAGCTATACG -> GTACCTCCCTAGCTATACGG
GGTAGCAACTTACACACCGA -> GTAGCAACTTACACACCGAC
GGTAGCAGACGGATCCATCC -> GTAGCAGACGGATCCATCCC
GGTAGTAGTACTCTCATGGC -> GTAGTAGTACTCTCATGGCT
GGTATATCTGTTGCGATGAG -> GTATATCTGTTGCGATGAGT
GGTCAAACGAAGAATCACAT -> GTCAAACGAAGAATCACATT
GGTCAGTTGCTGCATTCCCA -> GTCAGTTGCTGCATTCCCAT
GGTGAACAGCGGGTGTCGCT -> GTGAACAGCGGGTGTCGCTA
GGTGAAGAGGGATCGCCCTG -> GTGAAGAGGGATCGCCCTGA
GGTGAGAACCTAAGTCCCCG -> GTGAGAACCTAAGTCCCCGG
GGTGCCCTACGGCTCCTAGC -> GTGCCCTACGGCTCCTAGCA
GGTGCGTTTTCGCTTGATCT -> GTGCGTTTTCGCTTGATCTT
GGTGGACGTAATAATGCAAC -> GTGGACGTAATAATGCAACC
GGTGGAGCGGTGAGAACCTA -> GTGGAGCGGTGAGAACCTAA
GGTGGATGGCATCGTGTTCC -> GTGGATGGCATCGTGTTCCT
GGTGGTAGCAACTTACACAC -> GTGGTAGCAACTTACACACC
GGTGGTGCGTTTTCGCTTGA -> GTGGTGCGTTTTCGCTTGAT
GGTGTCGCTACCGTACCGTC -> GTGTCGCTACCGTACCGTCT
GGTGTTCTCTGCAGTAATCA -> GTGTTCTCTGCAGTAATCAG
GGTTAATATAACGAAGACTT -> GTTAATATAACGAAGACTTG
GGTTATTGTTATGCCCGCTA -> GTTATTGTTATGCCCGCTAG
GGTTCCCGGAAATATATTAA -> GTTCCCGGAAATATATTAAT
GGTTCGCCTAATGAGAGTCG -> GTTCGCCTAATGAGAGTCGC
GGTTGCAGGGCTGTTTTACT -> GTTGCAGGGCTGTTTTACTC
GGTTGCCACAGGTGGTAGCA -> GTTGCCACAGGTGGTAGCAA
GGTTGCGGATGCAGTAGGTG -> GTTGCGGATGCAGTAGGTGG
GGTTTAACCGCAAGGTGAAG -> GTTTAACCGCAAGGTGAAGA
GGTTTTTACTCCTCACACGG -> GTTTTTACTCCTCACACGGG
GTAAAATTTGCTGCAATCTT -> TAAAATTTGCTGCAATCTTA
GTAAATATGCTAAGCGATGA -> TAAATATGCTAAGCGATGAC
GTAACACCCTCGCGCGGGGA -> TAACACCCTCGCGCGGGGAG
GTAACCGGGTATATCTGTTG -> TAACCGGGTATATCTGTTGC
GTAAGGCTCGATAATGTCTA -> TAAGGCTCGATAATGTCTAC
GTAAGTAATGACTATTCTGA -> TAAGTAATGACTATTCTGAC
GTAATAATGCAACCTAGAAC -> TAATAATGCAACCTAGAACT
GTAATCAGCGTTGTAACACC -> TAATCAGCGTTGTAACACCC
GTAATGACTATTCTGACATC -> TAATGACTATTCTGACATCA
GTAATTAAACATATCTTAGT -> TAATTAAACATATCTTAGTG
GTAATTGTCGGGCATGAGTG -> TAATTGTCGGGCATGAGTGA
GTACAAGCAGGGGGTTGCGG -> TACAAGCAGGGGGTTGCGGA
GTACAATATTTTACTTCGCT -> TACAATATTTTACTTCGCTT
GTACACCGCTGCTTTTGTCG -> TACACCGCTGCTTTTGTCGA
GTACAGCGGGGTCAGTTGCT -> TACAGCGGGGTCAGTTGCTG
GTACAGCGGTGGACGTAATA -> TACAGCGGTGGACGTAATAA
GTACATCGTGGCTCGTCTTA -> TACATCGTGGCTCGTCTTAC
GTACCGTCTATTGCGCTAAT -> TACCGTCTATTGCGCTAATT
GTACCGTGCCGGTACCTCCC -> TACCGTGCCGGTACCTCCCT
GTACCTCCCTAGCTATACGG -> TACCTCCCTAGCTATACGGG
GTACGAGGTGGATGGCATCG -> TACGAGGTGGATGGCATCGT
GTACTCTCATGGCTGCTACC -> TACTCTCATGGCTGCTACCG
GTAGCAACTTACACACCGAC -> TAGCAACTTACACACCGACT
GTAGCAGACGGATCCATCCC -> TAGCAGACGGATCCATCCCT
GTAGCCTAAGGAGGGTGCCC -> TAGCCTAAGGAGGGTGCCCT
GTAGCTTTAAACGGTGTTCT -> TAGCTTTAAACGGTGTTCTC
GTAGGTGGTGCGTTTTCGCT -> TAGGTGGTGCGTTTTCGCTT
GTAGTACTCTCATGGCTGCT -> TAGTACTCTCATGGCTGCTA
GTAGTAGTACTCTCATGGCT -> TAGTAGTACTCTCATGGCTG
GTATATCTGTTGCGATGAGT -> TATATCTGTTGCGATGAGTT
GTATCGGCATTTTCCGTACA -> TATCGGCATTTTCCGTACAC
GTATGCCTATACTCTTTTAA -> TATGCCTATACTCTTTTAAT
GTATGGTTAATATAACGAAG -> TATGGTTAATATAACGAAGA
GTCAAACGAAGAATCACATT -> TCAAACGAAGAATCACATTG
GTCAAACTAAAAATCACGGT -> TCAAACTAAAAATCACGGTA
GTCAAACTAACGAATAATCG -> TCAAACTAACGAATAATCGA
GTCAAACTAAGAATATCACC -> TCAAACTAAGAATATCACCC
GTCAAACTAAGCCAAATTTA -> TCAAACTAAGCCAAATTTAT
GTCACTTCCCATAACAGTAA -> TCACTTCCCATAACAGTAAA
GTCAGGAAACTGACTTGTAG -> TCAGGAAACTGACTTGTAGC
GTCAGTTGCTGCATTCCCAT -> TCAGTTGCTGCATTCCCATT
GTCATCCTCAGTTTATACGC -> TCATCCTCAGTTTATACGCG
GTCATCTAGCAGGCATACCT -> TCATCTAGCAGGCATACCTA
GTCCCAGCCTCTTAATTTGT -> TCCCAGCCTCTTAATTTGTA
GTCCCCGGGGTGAACAGCGG -> TCCCCGGGGTGAACAGCGGG
GTCGACATGACACCGAAATC -> TCGACATGACACCGAAATCC
GTCGACATGACACCGCTCGA -> TCGACATGACACCGCTCGAC
GTCGACATGACACCGGCAAA -> TCGACATGACACCGGCAAAG
GTCGACATGACACCGTTGCC -> TCGACATGACACCGTTGCCG
GTCGCAGTGCGATTGCTTTA -> TCGCAGTGCGATTGCTTTAA
GTCGCATAACATTTGTCGAC -> TCGCATAACATTTGTCGACA
GTCGCCAGTCAGGAAACTGA -> TCGCCAGTCAGGAAACTGAC
GTCGCTACCGTACCGTCTAT -> TCGCTACCGTACCGTCTATT
GTCGCTACTTACAAACCTGA -> TCGCTACTTACAAACCTGAC
GTCGGGCATGAGTGAACCGC -> TCGGGCATGAGTGAACCGCA
GTCTACGATCACGCGAGTAA -> TCTACGATCACGCGAGTAAC
GTCTCGAGTTACCGACAAAA -> TCTCGAGTTACCGACAAAAG
GTCTGTTCAGCCCACATGAG -> TCTGTTCAGCCCACATGAGC
GTCTTACCATAGATGTTCGG -> TCTTACCATAGATGTTCGGT
GTCTTGCCGCTTTATCAGTT -> TCTTGCCGCTTTATCAGTTG
GTCTTTTGACAACTTTTCCT -> TCTTTTGACAACTTTTCCTA
GTGAACAGCGGGTGTCGCTA -> TGAACAGCGGGTGTCGCTAC
GTGAACCGCATGTTATTCTA -> TGAACCGCATGTTATTCTAC
GTGAACCGGCTGACGACCGA -> TGAACCGGCTGACGACCGAT
GTGAACCTGATGGCATTTAC -> TGAACCTGATGGCATTTACC
GTGAAGAGGGATCGCCCTGA -> TGAAGAGGGATCGCCCTGAC
GTGAAGGCAGCTACTCAAGT -> TGAAGGCAGCTACTCAAGTC
GTGAAGTCAAACTAAAAATC -> TGAAGTCAAACTAAAAATCA
GTGAAGTCAAACTAACGAAT -> TGAAGTCAAACTAACGAATA
GTGAAGTCAAACTAAGAATA -> TGAAGTCAAACTAAGAATAT
GTGAAGTCAAACTAAGCCAA -> TGAAGTCAAACTAAGCCAAA
GTGAGAACCTAAGTCCCCGG -> TGAGAACCTAAGTCCCCGGG
GTGAGTATGGTTAATATAAC -> TGAGTATGGTTAATATAACG
GTGATCCGCAATCTTATCAG -> TGATCCGCAATCTTATCAGG
GTGATGTTCTTCCGCCCCGC -> TGATGTTCTTCCGCCCCGCT
GTGCCCTACGGCTCCTAGCA -> TGCCCTACGGCTCCTAGCAT
GTGCCGGTACCTCCCTAGCT -> TGCCGGTACCTCCCTAGCTA
GTGCGATTGCTTTAAATGAC -> TGCGATTGCTTTAAATGACA
GTGCGTTTTCGCTTGATCTT -> TGCGTTTTCGCTTGATCTTC
GTGCTTGTTTTCGAAGAGGC -> TGCTTGTTTTCGAAGAGGCC
GTGGAAGCTGCAACATACTA -> TGGAAGCTGCAACATACTAT
GTGGACGTAATAATGCAACC -> TGGACGTAATAATGCAACCT
GTGGACTAAATACAGGATAG -> TGGACTAAATACAGGATAGA
GTGGAGCGGTGAGAACCTAA -> TGGAGCGGTGAGAACCTAAG
GTGGATGGCATCGTGTTCCT -> TGGATGGCATCGTGTTCCTA
GTGGCCGGTAATTGTCGGGC -> TGGCCGGTAATTGTCGGGCA
GTGGCTCGTCTTACCATAGA -> TGGCTCGTCTTACCATAGAT
GTGGGATACACTTCGAGCTG -> TGGGATACACTTCGAGCTGC
GTGGTAGCAACTTACACACC -> TGGTAGCAACTTACACACCG
GTGGTGCGTTTTCGCTTGAT -> TGGTGCGTTTTCGCTTGATC
GTGTACAATATTTTACTTCG -> TGTACAATATTTTACTTCGC
GTGTATCGGCATTTTCCGTA -> TGTATCGGCATTTTCCGTAC
GTGTCGCTACCGTACCGTCT -> TGTCGCTACCGTACCGTCTA
GTGTTAAGGACCGTGAGTAT -> TGTTAAGGACCGTGAGTATG
GTGTTATGGAGCTCGCATAC -> TGTTATGGAGCTCGCATACC
GTGTTCCTATGAATCCGGAC -> TGTTCCTATGAATCCGGACG
GTGTTCTCTGCAGTAATCAG -> TGTTCTCTGCAGTAATCAGC
GTTAAGGACCGTGAGTATGG -> TTAAGGACCGTGAGTATGGT
GTTAATATAACGAAGACTTG -> TTAATATAACGAAGACTTGA
GTTACCGACAAAAGCGTGGC -> TTACCGACAAAAGCGTGGCC
GTTAGTTGTGAAGTCAAACT -> TTAGTTGTGAAGTCAAACTA
GTTATGCCCGCTAGGGCATG -> TTATGCCCGCTAGGGCATGG
GTTATGGAGCTCGCATACCG -> TTATGGAGCTCGCATACCGC
GTTATTCTACTCTCAAACAC -> TTATTCTACTCTCAAACACC
GTTATTGTTATGCCCGCTAG -> TTATTGTTATGCCCGCTAGG
GTTCAGCCCACATGAGCGAC -> TTCAGCCCACATGAGCGACG
GTTCCCGGAAATATATTAAT -> TTCCCGGAAATATATTAATT
GTTCCTATGAATCCGGACGC -> TTCCTATGAATCCGGACGCA
GTTCGCATAAGTATGCCTAT -> TTCGCATAAGTATGCCTATA
GTTCGCCTAATGAGAGTCGC -> TTCGCCTAATGAGAGTCGCC
GTTCGGTTGCCACAGGTGGT -> TTCGGTTGCCACAGGTGGTA
GTTCTCTGCAGTAATCAGCG -> TTCTCTGCAGTAATCAGCGT
GTTCTTCCGCCCCGCTACAT -> TTCTTCCGCCCCGCTACATT
GTTGACCCTCCGCGCGTTCG -> TTGACCCTCCGCGCGTTCGC
GTTGCAGGGCTGTTTTACTC -> TTGCAGGGCTGTTTTACTCG
GTTGCCACAGGTGGTAGCAA -> TTGCCACAGGTGGTAGCAAC
GTTGCCGACGAAATGCTATG -> TTGCCGACGAAATGCTATGC
GTTGCCGCCGTTAGTTGTGA -> TTGCCGCCGTTAGTTGTGAA
GTTGCGATGAGTTTGTCGAC -> TTGCGATGAGTTTGTCGACA
GTTGCGGATGCAGTAGGTGG -> TTGCGGATGCAGTAGGTGGT
GTTGCTGCATTCCCATTGTC -> TTGCTGCATTCCCATTGTCT
GTTGTAACACCCTCGCGCGG -> TTGTAACACCCTCGCGCGGG
GTTGTACAAGCAGGGGGTTG -> TTGTACAAGCAGGGGGTTGC
GTTGTGAAGTCAAACTAAAA -> TTGTGAAGTCAAACTAAAAA
GTTGTGAAGTCAAACTAACG -> TTGTGAAGTCAAACTAACGA
GTTGTGAAGTCAAACTAAGA -> TTGTGAAGTCAAACTAAGAA
GTTGTGAAGTCAAACTAAGC -> TTGTGAAGTCAAACTAAGCC
GTTTAACCGCAAGGTGAAGA -> TTTAACCGCAAGGTGAAGAG
GTTTAGTTGTGAAGTCAAAC -> TTTAGTTGTGAAGTCAAACT
GTTTATACGCGGCACGGTTT -> TTTATACGCGGCACGGTTTA
GTTTCGTAATTAAACATATC -> TTTCGTAATTAAACATATCT
GTTTGCACTATGAAACATTG -> TTTGCACTATGAAACATTGG
GTTTGTCGACATGACACCGG -> TTTGTCGACATGACACCGGC
GTTTTACTCGTGGGATACAC -> TTTTACTCGTGGGATACACT
GTTTTCGAAGAGGCCCTTCT -> TTTTCGAAGAGGCCCTTCTC
GTTTTCGCTTGATCTTCTGG -> TTTTCGCTTGATCTTCTGGT
GTTTTTACTCCTCACACGGG -> TTTTTACTCCTCACACGGGC
TAAAAATCACGGTACCGTGC -> AAAAATCACGGTACCGTGCC
TAAAACGTCTTTTGACAACT -> AAAACGTCTTTTGACAACTT
TAAAATTTGCTGCAATCTTA -> AAAATTTGCTGCAATCTTAA
TAAACATATCTTAGTGGACT -> AAACATATCTTAGTGGACTA
TAAACGGTGTTCTCTGCAGT -> AAACGGTGTTCTCTGCAGTA
TAAAGGGCATGCGTACGAGG -> AAAGGGCATGCGTACGAGGT
TAAATACAGGATAGAGGGCG -> AAATACAGGATAGAGGGCGC
TAAATATGCTAAGCGATGAC -> AAATATGCTAAGCGATGACG
TAAATGACATAACGTCCCAG -> AAATGACATAACGTCCCAGC
TAACACCCTCGCGCGGGGAG -> AACACCCTCGCGCGGGGAGG
TAACAGTAAAATTTGCTGCA -> AACAGTAAAATTTGCTGCAA
TAACATTTGTCGACATGACA -> AACATTTGTCGACATGACAC
TAACCGCAAGGTGAAGAGGG -> AACCGCAAGGTGAAGAGGGA
TAACCGGGTATATCTGTTGC -> AACCGGGTATATCTGTTGCG
TAACCTTGACTCCTTAGGCA -> AACCTTGACTCCTTAGGCAT
TAACGAAGACTTGAATTACT -> AACGAAGACTTGAATTACTA
TAACGAATAATCGAGAGTCA -> AACGAATAATCGAGAGTCAT
TAACGTCCCAGCCTCTTAAT -> AACGTCCCAGCCTCTTAATT
TAAGAATATCACCCCGGCGT -> AAGAATATCACCCCGGCGTC
TAAGCCAAATTTATTTGATT -> AAGCCAAATTTATTTGATTC
TAAGCGATGACGGATACATT -> AAGCGATGACGGATACATTA
TAAGCTCCCACAGTACAGCG -> AAGCTCCCACAGTACAGCGG
TAAGGACCGTGAGTATGGTT -> AAGGACCGTGAGTATGGTTA
TAAGGAGGGTGCCCTACGGC -> AAGGAGGGTGCCCTACGGCT
TAAGGCTCGATAATGTCTAC -> AAGGCTCGATAATGTCTACG
TAAGTAATGACTATTCTGAC -> AAGTAATGACTATTCTGACA
TAAGTATGCCTATACTCTTT -> AAGTATGCCTATACTCTTTT
TAAGTCCCCGGGGTGAACAG -> AAGTCCCCGGGGTGAACAGC
TAATAATGCAACCTAGAACT -> AATAATGCAACCTAGAACTT
TAATATAACGAAGACTTGAA -> AATATAACGAAGACTTGAAT
TAATCAGCGTTGTAACACCC -> AATCAGCGTTGTAACACCCT
TAATCCATTTTATTCAACAG -> AATCCATTTTATTCAACAGA
TAATCGAGAGTCATCCTCAG -> AATCGAGAGTCATCCTCAGT
TAATCTTCGAATTCAACGCT -> AATCTTCGAATTCAACGCTA
TAATGACTATTCTGACATCA -> AATGACTATTCTGACATCAC
TAATGAGAGTCGCCAGTCAG -> AATGAGAGTCGCCAGTCAGG
TAATGCAACCTAGAACTTTC -> AATGCAACCTAGAACTTTCC
TAATGTCTACGATCACGCGA -> AATGTCTACGATCACGCGAG
TAATTAAACATATCTTAGTG -> AATTAAACATATCTTAGTGG
TAATTCCCAACACTAGGGGA -> AATTCCCAACACTAGGGGAA
TAATTGTCGGGCATGAGTGA -> AATTGTCGGGCATGAGTGAA
TAATTTGTACATCGTGGCTC -> AATTTGTACATCGTGGCTCG
TACAAACCTGACACAGACTC -> ACAAACCTGACACAGACTCC
TACAAGCAGGGGGTTGCGGA -> ACAAGCAGGGGGTTGCGGAT
TACAAGTGATGTTCTTCCGC -> ACAAGTGATGTTCTTCCGCC
TACAATATTTTACTTCGCTT -> ACAATATTTTACTTCGCTTT
TACACACCGACTGGTTATTG -> ACACACCGACTGGTTATTGT
TACACCAGCACTAGGTGGAG -> ACACCAGCACTAGGTGGAGC
TACACCGCTGCTTTTGTCGA -> ACACCGCTGCTTTTGTCGAC
TACACTTCGAGCTGCCTACG -> ACACTTCGAGCTGCCTACGT
TACAGCGGGGTCAGTTGCTG -> ACAGCGGGGTCAGTTGCTGC
TACAGCGGTGGACGTAATAA -> ACAGCGGTGGACGTAATAAT
TACAGGATAGAGGGCGCTAC -> ACAGGATAGAGGGCGCTACA
TACATCGAACAGGAATTACT -> ACATCGAACAGGAATTACTA
TACATCGTGGCTCGTCTTAC -> ACATCGTGGCTCGTCTTACC
TACATGTAAGGCTCGATAAT -> ACATGTAAGGCTCGATAATG
TACATTACATGTAAGGCTCG -> ACATTACATGTAAGGCTCGA
TACATTCGCGCAGGGCCAGT -> ACATTCGCGCAGGGCCAGTG
TACCATAACCTTGACTCCTT -> ACCATAACCTTGACTCCTTA
TACCATAGATGTTCGGTTGC -> ACCATAGATGTTCGGTTGCC
TACCCCGAAATCTACTTATA -> ACCCCGAAATCTACTTATAC
TACCGACAAAAGCGTGGCCG -> ACCGACAAAAGCGTGGCCGG
TACCGCAACGCAGGACTTGT -> ACCGCAACGCAGGACTTGTC
TACCGCCATAGCGACCTTTG -> ACCGCCATAGCGACCTTTGT
TACCGTACCGTCTATTGCGC -> ACCGTACCGTCTATTGCGCT
TACCGTGCCGGTACCTCCCT -> ACCGTGCCGGTACCTCCCTA
TACCTAGACGGCTTACCTGC -> ACCTAGACGGCTTACCTGCT
TACCTCCCTAGCTATACGGG -> ACCTCCCTAGCTATACGGGA
TACCTGCTTGCGATGTGTAT -> ACCTGCTTGCGATGTGTATC
TACGAGGTGGATGGCATCGT -> ACGAGGTGGATGGCATCGTG
TACGAGTGAAGGCAGCTACT -> ACGAGTGAAGGCAGCTACTC
TACGATCACGCGAGTAACCG -> ACGATCACGCGAGTAACCGG
TACGCGGCACGGTTTAACCG -> ACGCGGCACGGTTTAACCGC
TACGGCTCCTAGCATATGTA -> ACGGCTCCTAGCATATGTAC
TACGGGAAAGACCTCGCGCC -> ACGGGAAAGACCTCGCGCCG
TACGTTTGCACTATGAAACA -> ACGTTTGCACTATGAAACAT
TACTAATCCATTTTATTCAA -> ACTAATCCATTTTATTCAAC
TACTACGAGTGAAGGCAGCT -> ACTACGAGTGAAGGCAGCTA
TACTATATCCGTGTACAATA -> ACTATATCCGTGTACAATAT
TACTCAAGTCACTTCCCATA -> ACTCAAGTCACTTCCCATAA
TACTCCTCACACGGGCGTAA -> ACTCCTCACACGGGCGTAAG
TACTCGTGGGATACACTTCG -> ACTCGTGGGATACACTTCGA
TACTCTCAAACACCGTAAAT -> ACTCTCAAACACCGTAAATA
TACTCTCATGGCTGCTACCG -> ACTCTCATGGCTGCTACCGC
TACTCTTTTAATCTTCGAAT -> ACTCTTTTAATCTTCGAATT
TACTTACAAACCTGACACAG -> ACTTACAAACCTGACACAGA
TACTTATACACCAGCACTAG -> ACTTATACACCAGCACTAGG
TACTTCGCTTTCAGAGTGTT -> ACTTCGCTTTCAGAGTGTTA
TAGAACTTTCCGTCGCTACT -> AGAACTTTCCGTCGCTACTT
TAGACGGCTTACCTGCTTGC -> AGACGGCTTACCTGCTTGCG
TAGAGGGCGCTACAAGTGAT -> AGAGGGCGCTACAAGTGATG
TAGATGTTCGGTTGCCACAG -> AGATGTTCGGTTGCCACAGG
TAGCAACTTACACACCGACT -> AGCAACTTACACACCGACTG
TAGCAGACGGATCCATCCCT -> AGCAGACGGATCCATCCCTT
TAGCAGGCATACCTAGACGG -> AGCAGGCATACCTAGACGGC
TAGCATATGTACAGCGGTGG -> AGCATATGTACAGCGGTGGA
TAGCCTAAGGAGGGTGCCCT -> AGCCTAAGGAGGGTGCCCTA
TAGCGACCTTTGTCGACATG -> AGCGACCTTTGTCGACATGA
TAGCTATACGGGAAAGACCT -> AGCTATACGGGAAAGACCTC
TAGCTTTAAACGGTGTTCTC -> AGCTTTAAACGGTGTTCTCT
TAGGCACCGCGCCTCTCGAG -> AGGCACCGCGCCTCTCGAGC
TAGGCATCAGTGTTATGGAG -> AGGCATCAGTGTTATGGAGC
TAGGGCATGGAGGTTCCCGG -> AGGGCATGGAGGTTCCCGGA
TAGGGGAAATCACGTGAACC -> AGGGGAAATCACGTGAACCG
TAGGTGGAGCGGTGAGAACC -> AGGTGGAGCGGTGAGAACCT
TAGGTGGTGCGTTTTCGCTT -> AGGTGGTGCGTTTTCGCTTG
TAGTACTCTCATGGCTGCTA -> AGTACTCTCATGGCTGCTAC
TAGTAGTACTCTCATGGCTG -> AGTAGTACTCTCATGGCTGC
TAGTGATCCGCAATCTTATC -> AGTGATCCGCAATCTTATCA
TAGTGGAAGCTGCAACATAC -> AGTGGAAGCTGCAACATACT
TAGTGGACTAAATACAGGAT -> AGTGGACTAAATACAGGATA
TAGTTGTACAAGCAGGGGGT -> AGTTGTACAAGCAGGGGGTT
TAGTTGTGAAGTCAAACTAA -> AGTTGTGAAGTCAAACTAAA,AGTTGTGAAGTCAAACTAAG,AGTTGTGAAGTCAAACTAAC
TATAACGAAGACTTGAATTA -> ATAACGAAGACTTGAATTAC
TATACACCAGCACTAGGTGG -> ATACACCAGCACTAGGTGGA
TATACGCGGCACGGTTTAAC -> ATACGCGGCACGGTTTAACC
TATACGGGAAAGACCTCGCG -> ATACGGGAAAGACCTCGCGC
TATACTCTTTTAATCTTCGA -> ATACTCTTTTAATCTTCGAA
TATATCCGTGTACAATATTT -> ATATCCGTGTACAATATTTT
TATATCTGTTGCGATGAGTT -> ATATCTGTTGCGATGAGTTT
TATATTAATTCCCAACACTA -> ATATTAATTCCCAACACTAG
TATCACAGGGGAATCCTCGT -> ATCACAGGGGAATCCTCGTC
TATCACCCCGGCGTCATCTA -> ATCACCCCGGCGTCATCTAG
TATCAGGGGTTCGCCTAATG -> ATCAGGGGTTCGCCTAATGA
TATCAGTCTCGAGTTACCGA -> ATCAGTCTCGAGTTACCGAC
TATCAGTTGACCCTCCGCGC -> ATCAGTTGACCCTCCGCGCG
TATCCGTGTACAATATTTTA -> ATCCGTGTACAATATTTTAC
TATCGGAACATAGTGGAAGC -> ATCGGAACATAGTGGAAGCT
TATCGGCATTTTCCGTACAC -> ATCGGCATTTTCCGTACACC
TATCTGTTGCGATGAGTTTG -> ATCTGTTGCGATGAGTTTGT
TATCTTAGTGGACTAAATAC -> ATCTTAGTGGACTAAATACA
TATGAAACATTGGCGTCGCA -> ATGAAACATTGGCGTCGCAT
TATGAATCCGGACGCAAGAG -> ATGAATCCGGACGCAAGAGT
TATGCCCGCTAGGGCATGGA -> ATGCCCGCTAGGGCATGGAG
TATGCCTATACTCTTTTAAT -> ATGCCTATACTCTTTTAATC
TATGCTAAGCGATGACGGAT -> ATGCTAAGCGATGACGGATA
TATGCTGATTTTCAACGGGC -> ATGCTGATTTTCAACGGGCT
TATGGAGCTCGCATACCGCC -> ATGGAGCTCGCATACCGCCA
TATGGTTAATATAACGAAGA -> ATGGTTAATATAACGAAGAC
TATGTACAGCGGTGGACGTA -> ATGTACAGCGGTGGACGTAA
TATGTTTCGTAATTAAACAT -> ATGTTTCGTAATTAAACATA
TATTAATTCCCAACACTAGG -> ATTAATTCCCAACACTAGGG
TATTCAACAGAGGCATTGAT -> ATTCAACAGAGGCATTGATT
TATTCTACTCTCAAACACCG -> ATTCTACTCTCAAACACCGT
TATTCTGACATCACACGGTA -> ATTCTGACATCACACGGTAG
TATTGCCTGTGCTTGTTTTC -> ATTGCCTGTGCTTGTTTTCG
TATTGTTATGCCCGCTAGGG -> ATTGTTATGCCCGCTAGGGC
TATTTGATTCGGACCCCTAG -> ATTTGATTCGGACCCCTAGT
TATTTTACTTCGCTTTCAGA -> ATTTTACTTCGCTTTCAGAG
TCAAACACCGTAAATATGCT -> CAAACACCGTAAATATGCTA
TCAAACGAAGAATCACATTG -> CAAACGAAGAATCACATTGA
TCAAACTAAAAATCACGGTA -> CAAACTAAAAATCACGGTAC
TCAAACTAACGAATAATCGA -> CAAACTAACGAATAATCGAG
TCAAACTAAGAATATCACCC -> CAAACTAAGAATATCACCCC
TCAAACTAAGCCAAATTTAT -> CAAACTAAGCCAAATTTATT
TCAACAGAGGCATTGATTAT -> CAACAGAGGCATTGATTATG
TCAACGCTATTGCCTGTGCT -> CAACGCTATTGCCTGTGCTT
TCAACGGGCTAAAACGTCTT -> CAACGGGCTAAAACGTCTTT
TCAAGTCACTTCCCATAACA -> CAAGTCACTTCCCATAACAG
TCAATCTACATCGAACAGGA -> CAATCTACATCGAACAGGAA
TCACACGGGCGTAAGTAATG -> CACACGGGCGTAAGTAATGA
TCACACGGTAGCAGACGGAT -> CACACGGTAGCAGACGGATC
TCACAGGGGAATCCTCGTCG -> CACAGGGGAATCCTCGTCGC
TCACATTGACAGAGTAGCTT -> CACATTGACAGAGTAGCTTT
TCACCCCGGCGTCATCTAGC -> CACCCCGGCGTCATCTAGCA
TCACGCGAGTAACCGGGTAT -> CACGCGAGTAACCGGGTATA
TCACGGTACCGTGCCGGTAC -> CACGGTACCGTGCCGGTACC
TCACGTGAACCGGCTGACGA -> CACGTGAACCGGCTGACGAC
TCACTTCCCATAACAGTAAA -> CACTTCCCATAACAGTAAAA
TCAGAGTGTTAAGGACCGTG -> CAGAGTGTTAAGGACCGTGA
TCAGCCCACATGAGCGACGC -> CAGCCCACATGAGCGACGCT
TCAGCCTTATCAGTCTCGAG -> CAGCCTTATCAGTCTCGAGT
TCAGCGTTGTAACACCCTCG -> CAGCGTTGTAACACCCTCGC
TCAGGAAACTGACTTGTAGC -> CAGGAAACTGACTTGTAGCC
TCAGGGGTTCGCCTAATGAG -> CAGGGGTTCGCCTAATGAGA
TCAGTCTCGAGTTACCGACA -> CAGTCTCGAGTTACCGACAA
TCAGTGTTATGGAGCTCGCA -> CAGTGTTATGGAGCTCGCAT
TCAGTTGACCCTCCGCGCGT -> CAGTTGACCCTCCGCGCGTT
TCAGTTGCTGCATTCCCATT -> CAGTTGCTGCATTCCCATTG
TCAGTTTATACGCGGCACGG -> CAGTTTATACGCGGCACGGT
TCATCCTCAGTTTATACGCG -> CATCCTCAGTTTATACGCGG
TCATCTAGCAGGCATACCTA -> CATCTAGCAGGCATACCTAG
TCATGGCTGCTACCGCAACG -> CATGGCTGCTACCGCAACGC
TCCATCCCTTAGGCACCGCG -> CCATCCCTTAGGCACCGCGC
TCCATTTTATTCAACAGAGG -> CCATTTTATTCAACAGAGGC
TCCCAACACTAGGGGAAATC -> CCCAACACTAGGGGAAATCA
TCCCACAGTACAGCGGGGTC -> CCCACAGTACAGCGGGGTCA
TCCCAGCCTCTTAATTTGTA -> CCCAGCCTCTTAATTTGTAC
TCCCATAACAGTAAAATTTG -> CCCATAACAGTAAAATTTGC
TCCCATTGTCTTGCCGCTTT -> CCCATTGTCTTGCCGCTTTA
TCCCCGGGGTGAACAGCGGG -> CCCCGGGGTGAACAGCGGGT
TCCCGGAAATATATTAATTC -> CCCGGAAATATATTAATTCC
TCCCTAGCTATACGGGAAAG -> CCCTAGCTATACGGGAAAGA
TCCCTTAGGCACCGCGCCTC -> CCCTTAGGCACCGCGCCTCT
TCCGAAGAAGTTGTGAAGTC -> CCGAAGAAGTTGTGAAGTCA
TCCGATTCAATCTACATCGA -> CCGATTCAATCTACATCGAA
TCCGCAATCTTATCAGGGGT -> CCGCAATCTTATCAGGGGTT
TCCGCCCCGCTACATTCGCG -> CCGCCCCGCTACATTCGCGC
TCCGCGCGTTCGCATAAGTA -> CCGCGCGTTCGCATAAGTAT
TCCGGACGCAAGAGTTGCCG -> CCGGACGCAAGAGTTGCCGA
TCCGTACACCGCTGCTTTTG -> CCGTACACCGCTGCTTTTGT
TCCGTCGCTACTTACAAACC -> CCGTCGCTACTTACAAACCT
TCCGTGTACAATATTTTACT -> CCGTGTACAATATTTTACTT
TCCTAGCATATGTACAGCGG -> CCTAGCATATGTACAGCGGT
TCCTATCACAGGGGAATCCT -> CCTATCACAGGGGAATCCTC
TCCTATGAATCCGGACGCAA -> CCTATGAATCCGGACGCAAG
TCCTCACACGGGCGTAAGTA -> CCTCACACGGGCGTAAGTAA
TCCTCAGTTTATACGCGGCA -> CCTCAGTTTATACGCGGCAC
TCCTCGTCGCAGTGCGATTG -> CCTCGTCGCAGTGCGATTGC
TCCTTAGGCATCAGTGTTAT -> CCTTAGGCATCAGTGTTATG
TCGAACAGGAATTACTACGA -> CGAACAGGAATTACTACGAG
TCGAAGAGGCCCTTCTCAGC -> CGAAGAGGCCCTTCTCAGCC
TCGAATTCAACGCTATTGCC -> CGAATTCAACGCTATTGCCT
TCGACAGCCTAGTTGTGAAG -> CGACAGCCTAGTTGTGAAGT
TCGACATGACACCGAAATCC -> CGACATGACACCGAAATCCG
TCGACATGACACCGCTCGAC -> CGACATGACACCGCTCGACA
TCGACATGACACCGGCAAAG -> CGACATGACACCGGCAAAGA
TCGACATGACACCGTTGCCG -> CGACATGACACCGTTGCCGC
TCGAGAGTCATCCTCAGTTT -> CGAGAGTCATCCTCAGTTTA
TCGAGCGGGGTTGCAGGGCT -> CGAGCGGGGTTGCAGGGCTG
TCGAGCTGCCTACGTTTGCA -> CGAGCTGCCTACGTTTGCAC
TCGAGTTACCGACAAAAGCG -> CGAGTTACCGACAAAAGCGT
TCGATAATGTCTACGATCAC -> CGATAATGTCTACGATCACG
TCGCAGTGCGATTGCTTTAA -> CGCAGTGCGATTGCTTTAAA
TCGCATAACATTTGTCGACA -> CGCATAACATTTGTCGACAT
TCGCATAAGTATGCCTATAC -> CGCATAAGTATGCCTATACT
TCGCATACCGCCATAGCGAC -> CGCATACCGCCATAGCGACC
TCGCCAGTCAGGAAACTGAC -> CGCCAGTCAGGAAACTGACT
TCGCCCTGACGCGATCTGGT -> CGCCCTGACGCGATCTGGTC
TCGCCTAATGAGAGTCGCCA -> CGCCTAATGAGAGTCGCCAG
TCGCGCAGGGCCAGTGAACC -> CGCGCAGGGCCAGTGAACCT
TCGCGCCGAAGGACATGCGA -> CGCGCCGAAGGACATGCGAT
TCGCGCGGGGAGGGATGGTT -> CGCGCGGGGAGGGATGGTTT
TCGCTACCGTACCGTCTATT -> CGCTACCGTACCGTCTATTG
TCGCTACTTACAAACCTGAC -> CGCTACTTACAAACCTGACA
TCGCTTGATCTTCTGGTAGT -> CGCTTGATCTTCTGGTAGTA
TCGCTTTCAGAGTGTTAAGG -> CGCTTTCAGAGTGTTAAGGA
TCGGAACATAGTGGAAGCTG -> CGGAACATAGTGGAAGCTGC
TCGGACCCCTAGTTGTACAA -> CGGACCCCTAGTTGTACAAG
TCGGCATTTTCCGTACACCG -> CGGCATTTTCCGTACACCGC
TCGGGCATGAGTGAACCGCA -> CGGGCATGAGTGAACCGCAT
TCGGTTGCCACAGGTGGTAG -> CGGTTGCCACAGGTGGTAGC
TCGTAATTAAACATATCTTA -> CGTAATTAAACATATCTTAG
TCGTCGCAGTGCGATTGCTT -> CGTCGCAGTGCGATTGCTTT
TCGTCTTACCATAGATGTTC -> CGTCTTACCATAGATGTTCG
TCGTGGCTCGTCTTACCATA -> CGTGGCTCGTCTTACCATAG
TCGTGGGATACACTTCGAGC -> CGTGGGATACACTTCGAGCT
TCGTGTTCCTATGAATCCGG -> CGTGTTCCTATGAATCCGGA
TCTACATCGAACAGGAATTA -> CTACATCGAACAGGAATTAC
TCTACGATCACGCGAGTAAC -> CTACGATCACGCGAGTAACC
TCTACTCTCAAACACCGTAA -> CTACTCTCAAACACCGTAAA
TCTACTTATACACCAGCACT -> CTACTTATACACCAGCACTA
TCTAGCAGGCATACCTAGAC -> CTAGCAGGCATACCTAGACG
TCTCAAACACCGTAAATATG -> CTCAAACACCGTAAATATGC
TCTCAGCCTTATCAGTCTCG -> CTCAGCCTTATCAGTCTCGA
TCTCATGGCTGCTACCGCAA -> CTCATGGCTGCTACCGCAAC
TCTCGAGCGGGGTTGCAGGG -> CTCGAGCGGGGTTGCAGGGC
TCTCGAGTTACCGACAAAAG -> CTCGAGTTACCGACAAAAGC
TCTCTGCAGTAATCAGCGTT -> CTCTGCAGTAATCAGCGTTG
TCTGACATCACACGGTAGCA -> CTGACATCACACGGTAGCAG
TCTGCAGTAATCAGCGTTGT -> CTGCAGTAATCAGCGTTGTA
TCTGGTAGTAGTACTCTCAT -> CTGGTAGTAGTACTCTCATG
TCTGGTCAAACGAAGAATCA -> CTGGTCAAACGAAGAATCAC
TCTGTTCAGCCCACATGAGC -> CTGTTCAGCCCACATGAGCG
TCTGTTGCGATGAGTTTGTC -> CTGTTGCGATGAGTTTGTCG
TCTTAAAGGGCATGCGTACG -> CTTAAAGGGCATGCGTACGA
TCTTAATTTGTACATCGTGG -> CTTAATTTGTACATCGTGGC
TCTTACCATAGATGTTCGGT -> CTTACCATAGATGTTCGGTT
TCTTAGTGGACTAAATACAG -> CTTAGTGGACTAAATACAGG
TCTTATCAGGGGTTCGCCTA -> CTTATCAGGGGTTCGCCTAA
TCTTCCGCCCCGCTACATTC -> CTTCCGCCCCGCTACATTCG
TCTTCGAATTCAACGCTATT -> CTTCGAATTCAACGCTATTG
TCTTCTGGTAGTAGTACTCT -> CTTCTGGTAGTAGTACTCTC
TCTTGCCGCTTTATCAGTTG -> CTTGCCGCTTTATCAGTTGA
TCTTTTAATCTTCGAATTCA -> CTTTTAATCTTCGAATTCAA
TCTTTTGACAACTTTTCCTA -> CTTTTGACAACTTTTCCTAT
TGAAACATTGGCGTCGCATA -> GAAACATTGGCGTCGCATAA
TGAACAGCGGGTGTCGCTAC -> GAACAGCGGGTGTCGCTACC
TGAACCGCATGTTATTCTAC -> GAACCGCATGTTATTCTACT
TGAACCGGCTGACGACCGAT -> GAACCGGCTGACGACCGATA
TGAACCTGATGGCATTTACC -> GAACCTGATGGCATTTACCC
TGAAGAGGGATCGCCCTGAC -> GAAGAGGGATCGCCCTGACG
TGAAGGCAGCTACTCAAGTC -> GAAGGCAGCTACTCAAGTCA
TGAAGTCAAACTAAAAATCA -> GAAGTCAAACTAAAAATCAC
TGAAGTCAAACTAACGAATA -> GAAGTCAAACTAACGAATAA
TGAAGTCAAACTAAGAATAT -> GAAGTCAAACTAAGAATATC
TGAAGTCAAACTAAGCCAAA -> GAAGTCAAACTAAGCCAAAT
TGAATCCGGACGCAAGAGTT -> GAATCCGGACGCAAGAGTTG
TGAATTACTAATCCATTTTA -> GAATTACTAATCCATTTTAT
TGACAACTTTTCCTATCACA -> GACAACTTTTCCTATCACAG
TGACACAGACTCCGATTCAA -> GACACAGACTCCGATTCAAT
TGACACCGAAATCCGAAGAA -> GACACCGAAATCCGAAGAAG
TGACACCGCTCGACAGCCTA -> GACACCGCTCGACAGCCTAG
TGACACCGGCAAAGAGTTTA -> GACACCGGCAAAGAGTTTAG
TGACACCGTTGCCGCCGTTA -> GACACCGTTGCCGCCGTTAG
TGACAGAGTAGCTTTAAACG -> GACAGAGTAGCTTTAAACGG
TGACATAACGTCCCAGCCTC -> GACATAACGTCCCAGCCTCT
TGACATCACACGGTAGCAGA -> GACATCACACGGTAGCAGAC
TGACCCTCCGCGCGTTCGCA -> GACCCTCCGCGCGTTCGCAT
TGACGACCGATAAGCTCCCA -> GACGACCGATAAGCTCCCAC
TGACGCGATCTGGTCAAACG -> GACGCGATCTGGTCAAACGA
TGACGGATACATTACATGTA -> GACGGATACATTACATGTAA
TGACTATTCTGACATCACAC -> GACTATTCTGACATCACACG
TGACTCCTTAGGCATCAGTG -> GACTCCTTAGGCATCAGTGT
TGACTTGTAGCCTAAGGAGG -> GACTTGTAGCCTAAGGAGGG
TGAGAACCTAAGTCCCCGGG -> GAGAACCTAAGTCCCCGGGG
TGAGAGTCGCCAGTCAGGAA -> GAGAGTCGCCAGTCAGGAAA
TGAGCGACGCTTATCGGAAC -> GAGCGACGCTTATCGGAACA
TGAGTATGGTTAATATAACG -> GAGTATGGTTAATATAACGA
TGAGTGAACCGCATGTTATT -> GAGTGAACCGCATGTTATTC
TGAGTTTGTCGACATGACAC -> GAGTTTGTCGACATGACACC
TGATCCGCAATCTTATCAGG -> GATCCGCAATCTTATCAGGG
TGATCTTCTGGTAGTAGTAC -> GATCTTCTGGTAGTAGTACT
TGATGGCATTTACCCCGAAA -> GATGGCATTTACCCCGAAAT
TGATGTTCTTCCGCCCCGCT -> GATGTTCTTCCGCCCCGCTA
TGATTATGTTTCGTAATTAA -> GATTATGTTTCGTAATTAAA
TGATTCGGACCCCTAGTTGT -> GATTCGGACCCCTAGTTGTA
TGATTTTCAACGGGCTAAAA -> GATTTTCAACGGGCTAAAAC
TGCAACATACTATATCCGTG -> GCAACATACTATATCCGTGT
TGCAACCTAGAACTTTCCGT -> GCAACCTAGAACTTTCCGTC
TGCAATCTTAAAGGGCATGC -> GCAATCTTAAAGGGCATGCG
TGCACTATGAAACATTGGCG -> GCACTATGAAACATTGGCGT
TGCAGGGCTGTTTTACTCGT -> GCAGGGCTGTTTTACTCGTG
TGCAGTAATCAGCGTTGTAA -> GCAGTAATCAGCGTTGTAAC
TGCAGTAGGTGGTGCGTTTT -> GCAGTAGGTGGTGCGTTTTC
TGCATTCCCATTGTCTTGCC -> GCATTCCCATTGTCTTGCCG
TGCCACAGGTGGTAGCAACT -> GCCACAGGTGGTAGCAACTT
TGCCCGCTAGGGCATGGAGG -> GCCCGCTAGGGCATGGAGGT
TGCCCTACGGCTCCTAGCAT -> GCCCTACGGCTCCTAGCATA
TGCCGACGAAATGCTATGCT -> GCCGACGAAATGCTATGCTG
TGCCGCCGTTAGTTGTGAAG -> GCCGCCGTTAGTTGTGAAGT
TGCCGCTTTATCAGTTGACC -> GCCGCTTTATCAGTTGACCC
TGCCGGTACCTCCCTAGCTA -> GCCGGTACCTCCCTAGCTAT
TGCCTACGTTTGCACTATGA -> GCCTACGTTTGCACTATGAA
TGCCTATACTCTTTTAATCT -> GCCTATACTCTTTTAATCTT
TGCCTGTGCTTGTTTTCGAA -> GCCTGTGCTTGTTTTCGAAG
TGCGATACCATAACCTTGAC -> GCGATACCATAACCTTGACT
TGCGATGAGTTTGTCGACAT -> GCGATGAGTTTGTCGACATG
TGCGATGTGTATCGGCATTT -> GCGATGTGTATCGGCATTTT
TGCGATTGCTTTAAATGACA -> GCGATTGCTTTAAATGACAT
TGCGGATGCAGTAGGTGGTG -> GCGGATGCAGTAGGTGGTGC
TGCGTACGAGGTGGATGGCA -> GCGTACGAGGTGGATGGCAT
TGCGTTTTCGCTTGATCTTC -> GCGTTTTCGCTTGATCTTCT
TGCTAAGCGATGACGGATAC -> GCTAAGCGATGACGGATACA
TGCTACCGCAACGCAGGACT -> GCTACCGCAACGCAGGACTT
TGCTATGCTGATTTTCAACG -> GCTATGCTGATTTTCAACGG
TGCTGATTTTCAACGGGCTA -> GCTGATTTTCAACGGGCTAA
TGCTGCAATCTTAAAGGGCA -> GCTGCAATCTTAAAGGGCAT
TGCTGCATTCCCATTGTCTT -> GCTGCATTCCCATTGTCTTG
TGCTTGCGATGTGTATCGGC -> GCTTGCGATGTGTATCGGCA
TGCTTGTTTTCGAAGAGGCC -> GCTTGTTTTCGAAGAGGCCC
TGCTTTAAATGACATAACGT -> GCTTTAAATGACATAACGTC
TGCTTTTGTCGACATGACAC -> GCTTTTGTCGACATGACACC
TGGAAGCTGCAACATACTAT -> GGAAGCTGCAACATACTATA
TGGACGTAATAATGCAACCT -> GGACGTAATAATGCAACCTA
TGGACTAAATACAGGATAGA -> GGACTAAATACAGGATAGAG
TGGAGCGGTGAGAACCTAAG -> GGAGCGGTGAGAACCTAAGT
TGGAGCTCGCATACCGCCAT -> GGAGCTCGCATACCGCCATA
TGGAGGTTCCCGGAAATATA -> GGAGGTTCCCGGAAATATAT
TGGATGGCATCGTGTTCCTA -> GGATGGCATCGTGTTCCTAT
TGGCATCGTGTTCCTATGAA -> GGCATCGTGTTCCTATGAAT
TGGCATTTACCCCGAAATCT -> GGCATTTACCCCGAAATCTA
TGGCCGGTAATTGTCGGGCA -> GGCCGGTAATTGTCGGGCAT
TGGCGTCGCATAACATTTGT -> GGCGTCGCATAACATTTGTC
TGGCTCGTCTTACCATAGAT -> GGCTCGTCTTACCATAGATG
TGGCTGCTACCGCAACGCAG -> GGCTGCTACCGCAACGCAGG
TGGGATACACTTCGAGCTGC -> GGGATACACTTCGAGCTGCC
TGGTAGCAACTTACACACCG -> GGTAGCAACTTACACACCGA
TGGTAGTAGTACTCTCATGG -> GGTAGTAGTACTCTCATGGC
TGGTCAAACGAAGAATCACA -> GGTCAAACGAAGAATCACAT
TGGTGCGTTTTCGCTTGATC -> GGTGCGTTTTCGCTTGATCT
TGGTTAATATAACGAAGACT -> GGTTAATATAACGAAGACTT
TGGTTATTGTTATGCCCGCT -> GGTTATTGTTATGCCCGCTA
TGGTTTTTACTCCTCACACG -> GGTTTTTACTCCTCACACGG
TGTAACACCCTCGCGCGGGG -> GTAACACCCTCGCGCGGGGA
TGTAAGGCTCGATAATGTCT -> GTAAGGCTCGATAATGTCTA
TGTACAAGCAGGGGGTTGCG -> GTACAAGCAGGGGGTTGCGG
TGTACAATATTTTACTTCGC -> GTACAATATTTTACTTCGCT
TGTACAGCGGTGGACGTAAT -> GTACAGCGGTGGACGTAATA
TGTACATCGTGGCTCGTCTT -> GTACATCGTGGCTCGTCTTA
TGTAGCCTAAGGAGGGTGCC -> GTAGCCTAAGGAGGGTGCCC
TGTATCGGCATTTTCCGTAC -> GTATCGGCATTTTCCGTACA
TGTCGACATGACACCGAAAT -> GTCGACATGACACCGAAATC
TGTCGACATGACACCGCTCG -> GTCGACATGACACCGCTCGA
TGTCGACATGACACCGGCAA -> GTCGACATGACACCGGCAAA
TGTCGACATGACACCGTTGC -> GTCGACATGACACCGTTGCC
TGTCGCTACCGTACCGTCTA -> GTCGCTACCGTACCGTCTAT
TGTCGGGCATGAGTGAACCG -> GTCGGGCATGAGTGAACCGC
TGTCTACGATCACGCGAGTA -> GTCTACGATCACGCGAGTAA
TGTCTGTTCAGCCCACATGA -> GTCTGTTCAGCCCACATGAG
TGTCTTGCCGCTTTATCAGT -> GTCTTGCCGCTTTATCAGTT
TGTGAAGTCAAACTAAAAAT -> GTGAAGTCAAACTAAAAATC
TGTGAAGTCAAACTAACGAA -> GTGAAGTCAAACTAACGAAT
TGTGAAGTCAAACTAAGAAT -> GTGAAGTCAAACTAAGAATA
TGTGAAGTCAAACTAAGCCA -> GTGAAGTCAAACTAAGCCAA
TGTGCTTGTTTTCGAAGAGG -> GTGCTTGTTTTCGAAGAGGC
TGTGTATCGGCATTTTCCGT -> GTGTATCGGCATTTTCCGTA
TGTTAAGGACCGTGAGTATG -> GTTAAGGACCGTGAGTATGG
TGTTATGCCCGCTAGGGCAT -> GTTATGCCCGCTAGGGCATG
TGTTATGGAGCTCGCATACC -> GTTATGGAGCTCGCATACCG
TGTTATTCTACTCTCAAACA -> GTTATTCTACTCTCAAACAC
TGTTCAGCCCACATGAGCGA -> GTTCAGCCCACATGAGCGAC
TGTTCCTATGAATCCGGACG -> GTTCCTATGAATCCGGACGC
TGTTCGGTTGCCACAGGTGG -> GTTCGGTTGCCACAGGTGGT
TGTTCTCTGCAGTAATCAGC -> GTTCTCTGCAGTAATCAGCG
TGTTCTTCCGCCCCGCTACA -> GTTCTTCCGCCCCGCTACAT
TGTTGCGATGAGTTTGTCGA -> GTTGCGATGAGTTTGTCGAC
TGTTTCGTAATTAAACATAT -> GTTTCGTAATTAAACATATC
TGTTTTACTCGTGGGATACA -> GTTTTACTCGTGGGATACAC
TGTTTTCGAAGAGGCCCTTC -> GTTTTCGAAGAGGCCCTTCT
TTAAACATATCTTAGTGGAC -> TAAACATATCTTAGTGGACT
TTAAACGGTGTTCTCTGCAG -> TAAACGGTGTTCTCTGCAGT
TTAAAGGGCATGCGTACGAG -> TAAAGGGCATGCGTACGAGG
TTAAATGACATAACGTCCCA -> TAAATGACATAACGTCCCAG
TTAACCGCAAGGTGAAGAGG -> TAACCGCAAGGTGAAGAGGG
TTAAGGACCGTGAGTATGGT -> TAAGGACCGTGAGTATGGTT
TTAATATAACGAAGACTTGA -> TAATATAACGAAGACTTGAA
TTAATCTTCGAATTCAACGC -> TAATCTTCGAATTCAACGCT
TTAATTCCCAACACTAGGGG -> TAATTCCCAACACTAGGGGA
TTAATTTGTACATCGTGGCT -> TAATTTGTACATCGTGGCTC
TTACAAACCTGACACAGACT -> TACAAACCTGACACAGACTC
TTACACACCGACTGGTTATT -> TACACACCGACTGGTTATTG
TTACATGTAAGGCTCGATAA -> TACATGTAAGGCTCGATAAT
TTACCATAGATGTTCGGTTG -> TACCATAGATGTTCGGTTGC
TTACCCCGAAATCTACTTAT -> TACCCCGAAATCTACTTATA
TTACCGACAAAAGCGTGGCC -> TACCGACAAAAGCGTGGCCG
TTACCTGCTTGCGATGTGTA -> TACCTGCTTGCGATGTGTAT
TTACTAATCCATTTTATTCA -> TACTAATCCATTTTATTCAA
TTACTACGAGTGAAGGCAGC -> TACTACGAGTGAAGGCAGCT
TTACTCCTCACACGGGCGTA -> TACTCCTCACACGGGCGTAA
TTACTCGTGGGATACACTTC -> TACTCGTGGGATACACTTCG
TTACTTCGCTTTCAGAGTGT -> TACTTCGCTTTCAGAGTGTT
TTAGGCACCGCGCCTCTCGA -> TAGGCACCGCGCCTCTCGAG
TTAGGCATCAGTGTTATGGA -> TAGGCATCAGTGTTATGGAG
TTAGTGGACTAAATACAGGA -> TAGTGGACTAAATACAGGAT
TTAGTTGTGAAGTCAAACTA -> TAGTTGTGAAGTCAAACTAA
TTATACACCAGCACTAGGTG -> TATACACCAGCACTAGGTGG
TTATACGCGGCACGGTTTAA -> TATACGCGGCACGGTTTAAC
TTATCAGGGGTTCGCCTAAT -> TATCAGGGGTTCGCCTAATG
TTATCAGTCTCGAGTTACCG -> TATCAGTCTCGAGTTACCGA
TTATCAGTTGACCCTCCGCG -> TATCAGTTGACCCTCCGCGC
TTATCGGAACATAGTGGAAG -> TATCGGAACATAGTGGAAGC
TTATGCCCGCTAGGGCATGG -> TATGCCCGCTAGGGCATGGA
TTATGGAGCTCGCATACCGC -> TATGGAGCTCGCATACCGCC
TTATGTTTCGTAATTAAACA -> TATGTTTCGTAATTAAACAT
TTATTCAACAGAGGCATTGA -> TATTCAACAGAGGCATTGAT
TTATTCTACTCTCAAACACC -> TATTCTACTCTCAAACACCG
TTATTGTTATGCCCGCTAGG -> TATTGTTATGCCCGCTAGGG
TTATTTGATTCGGACCCCTA -> TATTTGATTCGGACCCCTAG
TTCAACAGAGGCATTGATTA -> TCAACAGAGGCATTGATTAT
TTCAACGCTATTGCCTGTGC -> TCAACGCTATTGCCTGTGCT
TTCAACGGGCTAAAACGTCT -> TCAACGGGCTAAAACGTCTT
TTCAATCTACATCGAACAGG -> TCAATCTACATCGAACAGGA
TTCAGAGTGTTAAGGACCGT -> TCAGAGTGTTAAGGACCGTG
TTCAGCCCACATGAGCGACG -> TCAGCCCACATGAGCGACGC
TTCCCAACACTAGGGGAAAT -> TCCCAACACTAGGGGAAATC
TTCCCATAACAGTAAAATTT -> TCCCATAACAGTAAAATTTG
TTCCCATTGTCTTGCCGCTT -> TCCCATTGTCTTGCCGCTTT
TTCCCGGAAATATATTAATT -> TCCCGGAAATATATTAATTC
TTCCGCCCCGCTACATTCGC -> TCCGCCCCGCTACATTCGCG
TTCCGTACACCGCTGCTTTT -> TCCGTACACCGCTGCTTTTG
TTCCGTCGCTACTTACAAAC -> TCCGTCGCTACTTACAAACC
TTCCTATCACAGGGGAATCC -> TCCTATCACAGGGGAATCCT
TTCCTATGAATCCGGACGCA -> TCCTATGAATCCGGACGCAA
TTCGAAGAGGCCCTTCTCAG -> TCGAAGAGGCCCTTCTCAGC
TTCGAATTCAACGCTATTGC -> TCGAATTCAACGCTATTGCC
TTCGAGCTGCCTACGTTTGC -> TCGAGCTGCCTACGTTTGCA
TTCGCATAAGTATGCCTATA -> TCGCATAAGTATGCCTATAC
TTCGCCTAATGAGAGTCGCC -> TCGCCTAATGAGAGTCGCCA
TTCGCGCAGGGCCAGTGAAC -> TCGCGCAGGGCCAGTGAACC
TTCGCTTGATCTTCTGGTAG -> TCGCTTGATCTTCTGGTAGT
TTCGCTTTCAGAGTGTTAAG -> TCGCTTTCAGAGTGTTAAGG
TTCGGACCCCTAGTTGTACA -> TCGGACCCCTAGTTGTACAA
TTCGGTTGCCACAGGTGGTA -> TCGGTTGCCACAGGTGGTAG
TTCGTAATTAAACATATCTT -> TCGTAATTAAACATATCTTA
TTCTACTCTCAAACACCGTA -> TCTACTCTCAAACACCGTAA
TTCTCAGCCTTATCAGTCTC -> TCTCAGCCTTATCAGTCTCG
TTCTCTGCAGTAATCAGCGT -> TCTCTGCAGTAATCAGCGTT
TTCTGACATCACACGGTAGC -> TCTGACATCACACGGTAGCA
TTCTGGTAGTAGTACTCTCA -> TCTGGTAGTAGTACTCTCAT
TTCTTCCGCCCCGCTACATT -> TCTTCCGCCCCGCTACATTC
TTGAATTACTAATCCATTTT -> TGAATTACTAATCCATTTTA
TTGACAACTTTTCCTATCAC -> TGACAACTTTTCCTATCACA
TTGACAGAGTAGCTTTAAAC -> TGACAGAGTAGCTTTAAACG
TTGACCCTCCGCGCGTTCGC -> TGACCCTCCGCGCGTTCGCA
TTGACTCCTTAGGCATCAGT -> TGACTCCTTAGGCATCAGTG
TTGATCTTCTGGTAGTAGTA -> TGATCTTCTGGTAGTAGTAC
TTGATTATGTTTCGTAATTA -> TGATTATGTTTCGTAATTAA
TTGATTCGGACCCCTAGTTG -> TGATTCGGACCCCTAGTTGT
TTGCACTATGAAACATTGGC -> TGCACTATGAAACATTGGCG
TTGCAGGGCTGTTTTACTCG -> TGCAGGGCTGTTTTACTCGT
TTGCCACAGGTGGTAGCAAC -> TGCCACAGGTGGTAGCAACT
TTGCCGACGAAATGCTATGC -> TGCCGACGAAATGCTATGCT
TTGCCGCCGTTAGTTGTGAA -> TGCCGCCGTTAGTTGTGAAG
TTGCCGCTTTATCAGTTGAC -> TGCCGCTTTATCAGTTGACC
TTGCCTGTGCTTGTTTTCGA -> TGCCTGTGCTTGTTTTCGAA
TTGCGATGAGTTTGTCGACA -> TGCGATGAGTTTGTCGACAT
TTGCGATGTGTATCGGCATT -> TGCGATGTGTATCGGCATTT
TTGCGGATGCAGTAGGTGGT -> TGCGGATGCAGTAGGTGGTG
TTGCTGCAATCTTAAAGGGC -> TGCTGCAATCTTAAAGGGCA
TTGCTGCATTCCCATTGTCT -> TGCTGCATTCCCATTGTCTT
TTGCTTTAAATGACATAACG -> TGCTTTAAATGACATAACGT
TTGGCGTCGCATAACATTTG -> TGGCGTCGCATAACATTTGT
TTGTAACACCCTCGCGCGGG -> TGTAACACCCTCGCGCGGGG
TTGTACAAGCAGGGGGTTGC -> TGTACAAGCAGGGGGTTGCG
TTGTACATCGTGGCTCGTCT -> TGTACATCGTGGCTCGTCTT
TTGTAGCCTAAGGAGGGTGC -> TGTAGCCTAAGGAGGGTGCC
TTGTCGACATGACACCGAAA -> TGTCGACATGACACCGAAAT
TTGTCGACATGACACCGCTC -> TGTCGACATGACACCGCTCG
TTGTCGACATGACACCGGCA -> TGTCGACATGACACCGGCAA
TTGTCGACATGACACCGTTG -> TGTCGACATGACACCGTTGC
TTGTCGGGCATGAGTGAACC -> TGTCGGGCATGAGTGAACCG
TTGTCTGTTCAGCCCACATG -> TGTCTGTTCAGCCCACATGA
TTGTCTTGCCGCTTTATCAG -> TGTCTTGCCGCTTTATCAGT
TTGTGAAGTCAAACTAAAAA -> TGTGAAGTCAAACTAAAAAT
TTGTGAAGTCAAACTAACGA -> TGTGAAGTCAAACTAACGAA
TTGTGAAGTCAAACTAAGAA -> TGTGAAGTCAAACTAAGAAT
TTGTGAAGTCAAACTAAGCC -> TGTGAAGTCAAACTAAGCCA
TTGTTATGCCCGCTAGGGCA -> TGTTATGCCCGCTAGGGCAT
TTGTTTTCGAAGAGGCCCTT -> TGTTTTCGAAGAGGCCCTTC
TTTAAACGGTGTTCTCTGCA -> TTAAACGGTGTTCTCTGCAG
TTTAAATGACATAACGTCCC -> TTAAATGACATAACGTCCCA
TTTAACCGCAAGGTGAAGAG -> TTAACCGCAAGGTGAAGAGG
TTTAATCTTCGAATTCAACG -> TTAATCTTCGAATTCAACGC
TTTACCCCGAAATCTACTTA -> TTACCCCGAAATCTACTTAT
TTTACTCCTCACACGGGCGT -> TTACTCCTCACACGGGCGTA
TTTACTCGTGGGATACACTT -> TTACTCGTGGGATACACTTC
TTTACTTCGCTTTCAGAGTG -> TTACTTCGCTTTCAGAGTGT
TTTAGTTGTGAAGTCAAACT -> TTAGTTGTGAAGTCAAACTA
TTTATACGCGGCACGGTTTA -> TTATACGCGGCACGGTTTAA
TTTATCAGTTGACCCTCCGC -> TTATCAGTTGACCCTCCGCG
TTTATTCAACAGAGGCATTG -> TTATTCAACAGAGGCATTGA
TTTATTTGATTCGGACCCCT -> TTATTTGATTCGGACCCCTA
TTTCAACGGGCTAAAACGTC -> TTCAACGGGCTAAAACGTCT
TTTCAGAGTGTTAAGGACCG -> TTCAGAGTGTTAAGGACCGT
TTTCCGTACACCGCTGCTTT -> TTCCGTACACCGCTGCTTTT
TTTCCGTCGCTACTTACAAA -> TTCCGTCGCTACTTACAAAC
TTTCCTATCACAGGGGAATC -> TTCCTATCACAGGGGAATCC
TTTCGAAGAGGCCCTTCTCA -> TTCGAAGAGGCCCTTCTCAG
TTTCGCTTGATCTTCTGGTA -> TTCGCTTGATCTTCTGGTAG
TTTCGTAATTAAACATATCT -> TTCGTAATTAAACATATCTT
TTTGACAACTTTTCCTATCA -> TTGACAACTTTTCCTATCAC
TTTGATTCGGACCCCTAGTT -> TTGATTCGGACCCCTAGTTG
TTTGCACTATGAAACATTGG -> TTGCACTATGAAACATTGGC
TTTGCTGCAATCTTAAAGGG -> TTGCTGCAATCTTAAAGGGC
TTTGTACATCGTGGCTCGTC -> TTGTACATCGTGGCTCGTCT
TTTGTCGACATGACACCGAA -> TTGTCGACATGACACCGAAA
TTTGTCGACATGACACCGCT -> TTGTCGACATGACACCGCTC
TTTGTCGACATGACACCGGC -> TTGTCGACATGACACCGGCA
TTTGTCGACATGACACCGTT -> TTGTCGACATGACACCGTTG
TTTTAATCTTCGAATTCAAC -> TTTAATCTTCGAATTCAACG
TTTTACTCCTCACACGGGCG -> TTTACTCCTCACACGGGCGT
TTTTACTCGTGGGATACACT -> TTTACTCGTGGGATACACTT
TTTTACTTCGCTTTCAGAGT -> TTTACTTCGCTTTCAGAGTG
TTTTATTCAACAGAGGCATT -> TTTATTCAACAGAGGCATTG
TTTTCAACGGGCTAAAACGT -> TTTCAACGGGCTAAAACGTC
TTTTCCGTACACCGCTGCTT -> TTTCCGTACACCGCTGCTTT
TTTTCCTATCACAGGGGAAT -> TTTCCTATCACAGGGGAATC
TTTTCGAAGAGGCCCTTCTC -> TTTCGAAGAGGCCCTTCTCA
TTTTCGCTTGATCTTCTGGT -> TTTCGCTTGATCTTCTGGTA
TTTTGACAACTTTTCCTATC -> TTTGACAACTTTTCCTATCA
TTTTGTCGACATGACACCGT -> TTTGTCGACATGACACCGTT
TTTTTACTCCTCACACGGGC -> TTTTACTCCTCACACGGGCG