AAAAGATGACC -> AAAGATGACCG
AAAAGCAAGAT -> AAAGCAAGATA
AAAAGTAGTCG -> AAAGTAGTCGA
AAACACTACCC -> AACACTACCCA
AAACCAGACCC -> AACCAGACCCG
AAACCATGGAC -> AACCATGGACC
AAACGACACTG -> AACGACACTGC
AAACGGTACTT -> AACGGTACTTC
AAACTATGGCC -> AACTATGGCCA
AAACTCGGTGA -> AACTCGGTGAG
AAAGAACCTAA -> AAGAACCTAAT
AAAGAATGTTT -> AAGAATGTTTG
AAAGACGATCC -> AAGACGATCCG
AAAGATGACCG -> AAGATGACCGT
AAAGCAAGATA -> AAGCAAGATAT
AAAGCCCCCAT -> AAGCCCCCATA
AAAGCCGTAGC -> AAGCCGTAGCA
AAAGCTCCATT -> AAGCTCCATTG
AAAGGCCGTAG -> AAGGCCGTAGC
AAAGGTATTCC -> AAGGTATTCCT
AAAGTAGTCGA -> AAGTAGTCGAA
AAAGTAGTTTG -> AAGTAGTTTGC
AAAGTTTCTAT -> AAGTTTCTATG
AAATAGGAAAT -> AATAGGAAATG
AAATCTGAGGT -> AATCTGAGGTA
AAATGATCAAG -> AATGATCAAGA
AAATGCCCATT -> AATGCCCATTT
AAATGCGCTGG -> AATGCGCTGGC
AAATTAGGAGA -> AATTAGGAGAC
AAATTAGTAAA -> AATTAGTAAAG
AACAACGTAAA -> ACAACGTAAAC
AACAACTCTCT -> ACAACTCTCTA
AACACACTGCA -> ACACACTGCAC
AACACCTTAAT -> ACACCTTAATT
AACACGGAATG -> ACACGGAATGT
AACACTACCCA -> ACACTACCCAG
AACATCTAGTG -> ACATCTAGTGG
AACCAAGCATA -> ACCAAGCATAA
AACCACTATTA -> ACCACTATTAC
AACCAGACCCG -> ACCAGACCCGA
AACCATGGACC -> ACCATGGACCA
AACCCAATCTG -> ACCCAATCTGA
AACCCGATGGC -> ACCCGATGGCA
AACCGCGGTGT -> ACCGCGGTGTA
AACCGGTTGGG -> ACCGGTTGGGA
AACCGTCGTTG -> ACCGTCGTTGT
AACCTAATTTC -> ACCTAATTTCA
AACCTCGGTAC -> ACCTCGGTACA
AACGACACTGC -> ACGACACTGCG
AACGACGCCAC -> ACGACGCCACA
AACGACTTGGG -> ACGACTTGGGT
AACGCACTAGG -> ACGCACTAGGT
AACGGAAGGGC -> ACGGAAGGGCT
AACGGATCACA -> ACGGATCACAC
AACGGTACTTC -> ACGGTACTTCA
AACGTAAACGG -> ACGTAAACGGT
AACGTAACGGA -> ACGTAACGGAA
AACGTTTTAGA -> ACGTTTTAGAA
AACTATGGCCA -> ACTATGGCCAA
AACTCGGTGAG -> ACTCGGTGAGA
AACTCTCTACC -> ACTCTCTACCC
AACTTCCGCTA -> ACTTCCGCTAA
AACTTTGGCAA -> ACTTTGGCAAA
AAGAACCTAAT -> AGAACCTAATT
AAGAAGTTTAC -> AGAAGTTTACT
AAGAATGTTTG -> AGAATGTTTGT
AAGACAAATAG -> AGACAAATAGG
AAGACCTAAAA -> AGACCTAAAAG
AAGACGATCCG -> AGACGATCCGA
AAGAGAGTAAA -> AGAGAGTAAAC
AAGAGGATAAA -> AGAGGATAAAG
AAGATAGTGTG -> AGATAGTGTGG
AAGATATTCGC -> AGATATTCGCG
AAGATGACCGT -> AGATGACCGTG
AAGCAAGATAT -> AGCAAGATATT
AAGCACGATTA -> AGCACGATTAC
AAGCATAACGA -> AGCATAACGAC
AAGCCCCCATA -> AGCCCCCATAA
AAGCCCGGTGA -> AGCCCGGTGAC
AAGCCGGATGG -> AGCCGGATGGC
AAGCCGTAGCA -> AGCCGTAGCAA
AAGCGCAACGC -> AGCGCAACGCA
AAGCTCCATTG -> AGCTCCATTGG
AAGGCACTGTC -> AGGCACTGTCC
AAGGCCGTAGC -> AGGCCGTAGCA
AAGGCGGTTAA -> AGGCGGTTAAT
AAGGGCGTCGA -> AGGGCGTCGAT
AAGGGCGTCTT -> AGGGCGTCTTA
AAGGGCTATTC -> AGGGCTATTCT
AAGGTATTCCT -> AGGTATTCCTC
AAGTAGTCGAA -> AGTAGTCGAAC
AAGTAGTTTGC -> AGTAGTTTGCA
AAGTCTCCAAA -> AGTCTCCAAAC
AAGTCTCTCTG -> AGTCTCTCTGC
AAGTGACGCCC -> AGTGACGCCCT
AAGTGAGGGAT -> AGTGAGGGATC
AAGTGGGGTCT -> AGTGGGGTCTC
AAGTTTACTTA -> AGTTTACTTAG
AAGTTTCTATG -> AGTTTCTATGG
AATAAGAGAGT -> ATAAGAGAGTA
AATACCACTAA -> ATACCACTAAC
AATACCGTCCG -> ATACCGTCCGC
AATACTCTGAA -> ATACTCTGAAG
AATAGGAAATG -> ATAGGAAATGC
AATCAAGCCCG -> ATCAAGCCCGG
AATCAGTTGGT -> ATCAGTTGGTC
AATCCAGTGAG -> ATCCAGTGAGT
AATCCCGGGAG -> ATCCCGGGAGC
AATCGGAAGGC -> ATCGGAAGGCG
AATCTGAAGGG -> ATCTGAAGGGC
AATCTGAGGTA -> ATCTGAGGTAG
AATGAAGACAA -> ATGAAGACAAA
AATGATCAAGA -> ATGATCAAGAA
AATGCCCATTT -> ATGCCCATTTA
AATGCGCTGGC -> ATGCGCTGGCT
AATGTAGTAGG -> ATGTAGTAGGC
AATGTGCGCCA -> ATGTGCGCCAT
AATGTTTGTCC -> ATGTTTGTCCC
AATTAAAGAAC -> ATTAAAGAACC
AATTACGGGGT -> ATTACGGGGTC
AATTAGGAGAC -> ATTAGGAGACC
AATTAGTAAAG -> ATTAGTAAAGG
AATTATAATAA -> ATTATAATAAG
AATTCAATTAC -> ATTCAATTACG
AATTCACTGTT -> ATTCACTGTTA
AATTGTATAAT -> ATTGTATAATC
AATTGTATCTT -> ATTGTATCTTG
AATTTAAAAGC -> ATTTAAAAGCA
AATTTCATTCT -> ATTTCATTCTA
AATTTTCCCTC -> ATTTTCCCTCC
ACAAAGCTCCA -> CAAAGCTCCAT
ACAAATAGGAA -> CAAATAGGAAA
ACAACAACGTA -> CAACAACGTAA
ACAACGTAAAC -> CAACGTAAACG
ACAACTCTCTA -> CAACTCTCTAC
ACAACTTCCGC -> CAACTTCCGCT
ACAAGACCTAA -> CAAGACCTAAA
ACAAGTGGGGT -> CAAGTGGGGTC
ACAATTATAAT -> CAATTATAATA
ACACAAAGCTC -> CACAAAGCTCC
ACACACTGCAC -> CACACTGCACT
ACACATCACGC -> CACATCACGCA
ACACCTTAATT -> CACCTTAATTC
ACACGGAATGT -> CACGGAATGTG
ACACGTAAATC -> CACGTAAATCT
ACACGTCAGTT -> CACGTCAGTTG
ACACTACCCAG -> CACTACCCAGT
ACACTGCACTC -> CACTGCACTCT
ACACTGCGGCT -> CACTGCGGCTT
ACACTGGTAGC -> CACTGGTAGCT
ACAGGAGAGTT -> CAGGAGAGTTC
ACAGTCCGACA -> CAGTCCGACAA
ACATATCGGGT -> CATATCGGGTA
ACATATTGCCT -> CATATTGCCTG
ACATCACGCAA -> CATCACGCAAG
ACATCTAGTGG -> CATCTAGTGGA
ACCAAATGCGC -> CCAAATGCGCT
ACCAACGACGC -> CCAACGACGCC
ACCAAGCATAA -> CCAAGCATAAC
ACCAATACTCT -> CCAATACTCTG
ACCAATTGTAT -> CCAATTGTATC
ACCACTAACGT -> CCACTAACGTT
ACCACTATTAC -> CCACTATTACA
ACCAGACCCGA -> CCAGACCCGAC
ACCAGGTTAAC -> CCAGGTTAACC
ACCAGTATTCT -> CCAGTATTCTG
ACCATGGACCA -> CCATGGACCAG
ACCATTGCAAC -> CCATTGCAACA
ACCCAATCTGA -> CCCAATCTGAA
ACCCACAACAA -> CCCACAACAAC
ACCCAGTCTTG -> CCCAGTCTTGC
ACCCCGATTTG -> CCCCGATTTGA
ACCCCTGGTTA -> CCCCTGGTTAA
ACCCGACCAAT -> CCCGACCAATT
ACCCGATGGCA -> CCCGATGGCAA
ACCCGTGCTCA -> CCCGTGCTCAG
ACCCTACCGAG -> CCCTACCGAGG
ACCGAGGCCCC -> CCGAGGCCCCA
ACCGCGGTGTA -> CCGCGGTGTAT
ACCGGTTGGGA -> CCGGTTGGGAT
ACCGTCCGCGA -> CCGTCCGCGAT
ACCGTCGTAAC -> CCGTCGTAACC
ACCGTCGTTGT -> CCGTCGTTGTA
ACCGTGCAAGC -> CCGTGCAAGCA
ACCTAAAAGAT -> CCTAAAAGATG
ACCTAATTTCA -> CCTAATTTCAT
ACCTAGGTTGG -> CCTAGGTTGGG
ACCTCACTTGA -> CCTCACTTGAG
ACCTCGGTACA -> CCTCGGTACAC
ACCTTAATTCA -> CCTTAATTCAA
ACGAAAAGTAG -> CGAAAAGTAGT
ACGAAGTGAGG -> CGAAGTGAGGG
ACGACACTGCG -> CGACACTGCGG
ACGACGCCACA -> CGACGCCACAC
ACGACTTGGGT -> CGACTTGGGTT
ACGAGAAACTC -> CGAGAAACTCG
ACGAGGGCCTC -> CGAGGGCCTCT
ACGATCCGAGC -> CGATCCGAGCT
ACGATTACTTA -> CGATTACTTAA
ACGCAAGATAG -> CGCAAGATAGT
ACGCACTAGGT -> CGCACTAGGTC
ACGCCACACGT -> CGCCACACGTA
ACGCCCACGGG -> CGCCCACGGGT
ACGCCCTGTCG -> CGCCCTGTCGA
ACGCCTGGAGA -> CGCCTGGAGAC
ACGGAAGGGCT -> CGGAAGGGCTA
ACGGAATGTGC -> CGGAATGTGCG
ACGGATCACAC -> CGGATCACACT
ACGGCGAACCT -> CGGCGAACCTC
ACGGGGTCACC -> CGGGGTCACCA
ACGGGTCGATA -> CGGGTCGATAG
ACGGTACTTCA -> CGGTACTTCAA
ACGGTGGTAGT -> CGGTGGTAGTG
ACGTAAACGGT -> CGTAAACGGTA
ACGTAAATCTG -> CGTAAATCTGA
ACGTAACGGAA -> CGTAACGGAAG
ACGTATCTCCT -> CGTATCTCCTT
ACGTCAGTTGG -> CGTCAGTTGGC
ACGTGAGTGAA -> CGTGAGTGAAG
ACGTGTTCTAA -> CGTGTTCTAAT
ACGTTAACACC -> CGTTAACACCT
ACGTTGTCTCG -> CGTTGTCTCGA
ACGTTTTAGAA -> CGTTTTAGAAA
ACTAACGTTTT -> CTAACGTTTTA
ACTACCATTGC -> CTACCATTGCA
ACTACCCAGTC -> CTACCCAGTCT
ACTAGCGCCAT -> CTAGCGCCATG
ACTAGCGGCTT -> CTAGCGGCTTT
ACTAGGTCAGG -> CTAGGTCAGGT
ACTATGGCCAA -> CTATGGCCAAA
ACTATTACACG -> CTATTACACGT
ACTCGGCCACT -> CTCGGCCACTG
ACTCGGTGAGA -> CTCGGTGAGAT
ACTCGGTTCCG -> CTCGGTTCCGC
ACTCTCTACCC -> CTCTCTACCCG
ACTCTCTTTAC -> CTCTCTTTACG
ACTCTGAAGTC -> CTCTGAAGTCT
ACTGACTGCTC -> CTGACTGCTCC
ACTGCACTCTC -> CTGCACTCTCT
ACTGCGCGTCC -> CTGCGCGTCCG
ACTGCGGCTTT -> CTGCGGCTTTG
ACTGCTCCTGT -> CTGCTCCTGTG
ACTGGGCCAAT -> CTGGGCCAATC
ACTGGTAGCTT -> CTGGTAGCTTG
ACTGTCCCTTC -> CTGTCCCTTCC
ACTGTTATCGC -> CTGTTATCGCG
ACTTAAATTAG -> CTTAAATTAGG
ACTTAAGTCTC -> CTTAAGTCTCT
ACTTAGCCCGT -> CTTAGCCCGTC
ACTTATGTAAC -> CTTATGTAACG
ACTTCAAGTGA -> CTTCAAGTGAC
ACTTCACTTCC -> CTTCACTTCCT
ACTTCAGTCGG -> CTTCAGTCGGA
ACTTCCGCTAA -> CTTCCGCTAAC
ACTTCCTCGAA -> CTTCCTCGAAA
ACTTGACTAGC -> CTTGACTAGCG
ACTTGAGTGAA -> CTTGAGTGAAT
ACTTGGGTTAG -> CTTGGGTTAGG
ACTTTGGCAAA -> CTTTGGCAAAC
ACTTTTAGTCC -> CTTTTAGTCCG
AGAAACTCGGT -> GAAACTCGGTG
AGAAAGAATGT -> GAAAGAATGTT
AGAAAGCCCCC -> GAAAGCCCCCA
AGAAAGCCGTA -> GAAAGCCGTAG
AGAACCTAATT -> GAACCTAATTT
AGAAGTTTACT -> GAAGTTTACTT
AGAATGTTTGT -> GAATGTTTGTC
AGAATTGTATA -> GAATTGTATAA
AGACAAATAGG -> GACAAATAGGA
AGACCAACGAC -> GACCAACGACG
AGACCCCTGGT -> GACCCCTGGTT
AGACCCGACCA -> GACCCGACCAA
AGACCTAAAAG -> GACCTAAAAGA
AGACGAAGTGA -> GACGAAGTGAG
AGACGATCCGA -> GACGATCCGAG
AGACTTTTAGT -> GACTTTTAGTC
AGAGAGTAAAC -> GAGAGTAAACA
AGAGGATAAAG -> GAGGATAAAGG
AGAGTAAACAC -> GAGTAAACACT
AGAGTTCCCGG -> GAGTTCCCGGA
AGATAGCGCCG -> GATAGCGCCGA
AGATAGTGTGG -> GATAGTGTGGA
AGATATTCGCG -> GATATTCGCGC
AGATCCGCTTT -> GATCCGCTTTC
AGATCGAATAC -> GATCGAATACC
AGATGACCGTG -> GATGACCGTGC
AGCAAGATATT -> GCAAGATATTC
AGCAATCAGTT -> GCAATCAGTTG
AGCACAGGAGA -> GCACAGGAGAG
AGCACGATTAC -> GCACGATTACT
AGCATAACGAC -> GCATAACGACT
AGCATACGTGT -> GCATACGTGTT
AGCATTGACGT -> GCATTGACGTT
AGCCCCCATAA -> GCCCCCATAAA
AGCCCGGTGAC -> GCCCGGTGACT
AGCCCGTCACA -> GCCCGTCACAG
AGCCGGATGGC -> GCCGGATGGCG
AGCCGTAGCAA -> GCCGTAGCAAT
AGCGAAGGGCG -> GCGAAGGGCGT
AGCGCAACGCA -> GCGCAACGCAC
AGCGCCATGTT -> GCGCCATGTTC
AGCGCCGATTG -> GCGCCGATTGG
AGCGGCTTTCG -> GCGGCTTTCGG
AGCGTATCTAC -> GCGTATCTACC
AGCTCAACCAA -> GCTCAACCAAG
AGCTCATCGGC -> GCTCATCGGCC
AGCTCCATTGG -> GCTCCATTGGT
AGCTGACGTTG -> GCTGACGTTGT
AGCTGAGTCAC -> GCTGAGTCACC
AGCTGCCTGGA -> GCTGCCTGGAA
AGCTGTTGTAT -> GCTGTTGTATT
AGCTTGGGCCA -> GCTTGGGCCAC
AGCTTTCCACA -> GCTTTCCACAA
AGGAAACCAGA -> GGAAACCAGAC
AGGAAATGCCC -> GGAAATGCCCA
AGGAGACCAAC -> GGAGACCAACG
AGGAGAGTTCC -> GGAGAGTTCCC
AGGATAAAGGC -> GGATAAAGGCC
AGGCACTGTCC -> GGCACTGTCCC
AGGCCCCAGTT -> GGCCCCAGTTG
AGGCCCTAAGG -> GGCCCTAAGGC
AGGCCGTAGCA -> GGCCGTAGCAT
AGGCCTGAACA -> GGCCTGAACAC
AGGCGGTTAAT -> GGCGGTTAATG
AGGCTGGTGCG -> GGCTGGTGCGC
AGGGATCATGT -> GGGATCATGTG
AGGGCCTCTCC -> GGGCCTCTCCC
AGGGCGTCGAT -> GGGCGTCGATA
AGGGCGTCTTA -> GGGCGTCTTAC
AGGGCTATTCT -> GGGCTATTCTC
AGGTAGGAAAC -> GGTAGGAAACC
AGGTATCTACC -> GGTATCTACCA
AGGTATTCCTC -> GGTATTCCTCA
AGGTCAGGTGT -> GGTCAGGTGTC
AGGTGTCCCCG -> GGTGTCCCCGT
AGGTTAACCGC -> GGTTAACCGCG
AGGTTGGGCGC -> GGTTGGGCGCA
AGTAAACACTA -> GTAAACACTAC
AGTAAAGGTAT -> GTAAAGGTATT
AGTAGGCTGGT -> GTAGGCTGGTG
AGTAGTCGAAC -> GTAGTCGAACT
AGTAGTTTGCA -> GTAGTTTGCAT
AGTATTCTGTA -> GTATTCTGTAC
AGTCACCCTAC -> GTCACCCTACC
AGTCACCGTCG -> GTCACCGTCGT
AGTCCGACAAT -> GTCCGACAATT
AGTCCGGCGAC -> GTCCGGCGACG
AGTCGAACTTT -> GTCGAACTTTG
AGTCGGAGATC -> GTCGGAGATCC
AGTCTCCAAAC -> GTCTCCAAACT
AGTCTCTCTGC -> GTCTCTCTGCC
AGTCTTGCCAT -> GTCTTGCCATC
AGTGAAGCGCA -> GTGAAGCGCAA
AGTGAATCAAG -> GTGAATCAAGC
AGTGACGCCCT -> GTGACGCCCTG
AGTGAGGGATC -> GTGAGGGATCA
AGTGAGTTGGG -> GTGAGTTGGGG
AGTGGATCCGA -> GTGGATCCGAA
AGTGGCTGCGG -> GTGGCTGCGGT
AGTGGGAGGCC -> GTGGGAGGCCC
AGTGGGGTCTC -> GTGGGGTCTCT
AGTGTCCAGAA -> GTGTCCAGAAA
AGTGTGGATGA -> GTGTGGATGAT
AGTTAGCACAG -> GTTAGCACAGG
AGTTCCCGGAC -> GTTCCCGGACT
AGTTCTTGCTG -> GTTCTTGCTGC
AGTTGCACTAC -> GTTGCACTACC
AGTTGCTATAG -> GTTGCTATAGT
AGTTGGATGCA -> GTTGGATGCAC
AGTTGGCTTAG -> GTTGGCTTAGA
AGTTGGGGACC -> GTTGGGGACCC
AGTTGGTCCAC -> GTTGGTCCACT
AGTTTACTTAG -> GTTTACTTAGC
AGTTTCTATGG -> GTTTCTATGGG
AGTTTGCATAA -> GTTTGCATAAC
ATAAAGGCCGT -> TAAAGGCCGTA
ATAAAGTAGTT -> TAAAGTAGTTT
ATAACACGGAA -> TAACACGGAAT
ATAACCACTAT -> TAACCACTATT
ATAACGACTTG -> TAACGACTTGG
ATAACGTAACG -> TAACGTAACGG
ATAAGAGAGTA -> TAAGAGAGTAA
ATAATAAGAGA -> TAATAAGAGAG
ATAATCCAGTG -> TAATCCAGTGA
ATACACATCAC -> TACACATCACG
ATACCACTAAC -> TACCACTAACG
ATACCGTCCGC -> TACCGTCCGCG
ATACCTCACTT -> TACCTCACTTG
ATACGAGAAAC -> TACGAGAAACT
ATACGTGTTCT -> TACGTGTTCTA
ATACTCTGAAG -> TACTCTGAAGT
ATAGAAAGCCC -> TAGAAAGCCCC
ATAGCGCCGAT -> TAGCGCCGATT
ATAGCTGCCTG -> TAGCTGCCTGG
ATAGGAAATGC -> TAGGAAATGCC
ATAGTGTGGAT -> TAGTGTGGATG
ATAGTTGGATG -> TAGTTGGATGC
ATATCGGGTAA -> TATCGGGTAAG
ATATCTTGGAC -> TATCTTGGACT
ATATTCGCGCT -> TATTCGCGCTT
ATATTGCCTGT -> TATTGCCTGTA
ATATTTCGTAG -> TATTTCGTAGA
ATCAAGAAGTT -> TCAAGAAGTTT
ATCAAGCCCGG -> TCAAGCCCGGT
ATCACACTGGT -> TCACACTGGTA
ATCACGCAAGA -> TCACGCAAGAT
ATCAGTTGGTC -> TCAGTTGGTCC
ATCATGTGCAC -> TCATGTGCACT
ATCCAGTGAGT -> TCCAGTGAGTT
ATCCATTCATC -> TCCATTCATCC
ATCCCGGGAGC -> TCCCGGGAGCG
ATCCCTCAGCT -> TCCCTCAGCTG
ATCCCTGTCGC -> TCCCTGTCGCG
ATCCGAATCCC -> TCCGAATCCCG
ATCCGAGCTGA -> TCCGAGCTGAG
ATCCGCTTTCG -> TCCGCTTTCGG
ATCCTACATAT -> TCCTACATATT
ATCGAATACCA -> TCGAATACCAC
ATCGATGGGTG -> TCGATGGGTGT
ATCGCGGCTCC -> TCGCGGCTCCT
ATCGGAAGGCG -> TCGGAAGGCGG
ATCGGCCCAGT -> TCGGCCCAGTC
ATCGGCTATAA -> TCGGCTATAAC
ATCGGGTAAGA -> TCGGGTAAGAG
ATCGTACGCCC -> TCGTACGCCCA
ATCTACCAAAT -> TCTACCAAATG
ATCTACCAATA -> TCTACCAATAC
ATCTAGTGGAT -> TCTAGTGGATC
ATCTCACATAT -> TCTCACATATC
ATCTCCTTGGA -> TCTCCTTGGAG
ATCTGAAGGGC -> TCTGAAGGGCG
ATCTGAGGTAG -> TCTGAGGTAGG
ATCTTACGGTG -> TCTTACGGTGG
ATCTTGATTGG -> TCTTGATTGGA
ATCTTGGACTT -> TCTTGGACTTC
ATGAAGACAAA -> TGAAGACAAAT
ATGACCGTGCA -> TGACCGTGCAA
ATGACGTGAGT -> TGACGTGAGTG
ATGAGCGTATC -> TGAGCGTATCT
ATGATAGAAAG -> TGATAGAAAGC
ATGATCAAGAA -> TGATCAAGAAG
ATGATCGATGG -> TGATCGATGGG
ATGCACTCGGC -> TGCACTCGGCC
ATGCCCATTTA -> TGCCCATTTAT
ATGCGCTGGCT -> TGCGCTGGCTC
ATGGAAATGAT -> TGGAAATGATC
ATGGACCAGTA -> TGGACCAGTAT
ATGGAGTTAGC -> TGGAGTTAGCA
ATGGCAATGAA -> TGGCAATGAAG
ATGGCCAAACC -> TGGCCAAACCA
ATGGCGCGTCC -> TGGCGCGTCCA
ATGGGACCTAG -> TGGGACCTAGG
ATGGGTGTTAT -> TGGGTGTTATA
ATGTAACGGAT -> TGTAACGGATC
ATGTACTTGAC -> TGTACTTGACT
ATGTAGTAGGC -> TGTAGTAGGCT
ATGTCCGCGCG -> TGTCCGCGCGC
ATGTGCACTCG -> TGTGCACTCGG
ATGTGCGCCAT -> TGTGCGCCATC
ATGTGGCGGGA -> TGTGGCGGGAA
ATGTTCAGTGG -> TGTTCAGTGGG
ATGTTCCAGAC -> TGTTCCAGACT
ATGTTTGTCCC -> TGTTTGTCCCC
ATTAAAGAACC -> TTAAAGAACCT
ATTACACGTCA -> TTACACGTCAG
ATTACGGGGTC -> TTACGGGGTCA
ATTACTTAAAT -> TTACTTAAATT
ATTAGGAGACC -> TTAGGAGACCA
ATTAGTAAAGG -> TTAGTAAAGGT
ATTATAATAAG -> TTATAATAAGA
ATTCAATTACG -> TTCAATTACGG
ATTCACTGTTA -> TTCACTGTTAT
ATTCATCCCTC -> TTCATCCCTCA
ATTCCTCATAC -> TTCCTCATACG
ATTCGCGCTTA -> TTCGCGCTTAC
ATTCTATGTCC -> TTCTATGTCCG
ATTCTCACGAG -> TTCTCACGAGG
ATTCTGTACTT -> TTCTGTACTTA
ATTGACGTTAA -> TTGACGTTAAC
ATTGCAACATC -> TTGCAACATCT
ATTGCCTGTAT -> TTGCCTGTATC
ATTGGACTGGG -> TTGGACTGGGC
ATTGGCATACC -> TTGGCATACCT
ATTGGTATCCA -> TTGGTATCCAT
ATTGTATAATC -> TTGTATAATCC
ATTGTATCTTG -> TTGTATCTTGA
ATTTAAAAGCA -> TTTAAAAGCAA
ATTTATCGTAC -> TTTATCGTACG
ATTTCATTCTA -> TTTCATTCTAT
ATTTCGTAGAA -> TTTCGTAGAAT
ATTTGATCCTA -> TTTGATCCTAC
ATTTTCCCTCC -> TTTTCCCTCCG
CAAACCATGGA -> AAACCATGGAC
CAAACGACACT -> AAACGACACTG
CAAACTATGGC -> AAACTATGGCC
CAAAGCTCCAT -> AAAGCTCCATT
CAAAGTTTCTA -> AAAGTTTCTAT
CAAATAGGAAA -> AAATAGGAAAT
CAAATGCGCTG -> AAATGCGCTGG
CAAATTAGTAA -> AAATTAGTAAA
CAACAACGTAA -> AACAACGTAAA
CAACAACTCTC -> AACAACTCTCT
CAACATCTAGT -> AACATCTAGTG
CAACCAAGCAT -> AACCAAGCATA
CAACGACGCCA -> AACGACGCCAC
CAACGCACTAG -> AACGCACTAGG
CAACGTAAACG -> AACGTAAACGG
CAACTCTCTAC -> AACTCTCTACC
CAACTTCCGCT -> AACTTCCGCTA
CAAGAAGTTTA -> AAGAAGTTTAC
CAAGACCTAAA -> AAGACCTAAAA
CAAGATAGTGT -> AAGATAGTGTG
CAAGATATTCG -> AAGATATTCGC
CAAGCACGATT -> AAGCACGATTA
CAAGCATAACG -> AAGCATAACGA
CAAGCCCGGTG -> AAGCCCGGTGA
CAAGTGACGCC -> AAGTGACGCCC
CAAGTGGGGTC -> AAGTGGGGTCT
CAATACTCTGA -> AATACTCTGAA
CAATCAGTTGG -> AATCAGTTGGT
CAATCGGAAGG -> AATCGGAAGGC
CAATCTGAAGG -> AATCTGAAGGG
CAATGAAGACA -> AATGAAGACAA
CAATTACGGGG -> AATTACGGGGT
CAATTATAATA -> AATTATAATAA
CAATTGTATCT -> AATTGTATCTT
CACAAAGCTCC -> ACAAAGCTCCA
CACAACAACGT -> ACAACAACGTA
CACAACTTCCG -> ACAACTTCCGC
CACAAGACCTA -> ACAAGACCTAA
CACAAGTGGGG -> ACAAGTGGGGT
CACACGTAAAT -> ACACGTAAATC
CACACTGCACT -> ACACTGCACTC
CACACTGGTAG -> ACACTGGTAGC
CACAGGAGAGT -> ACAGGAGAGTT
CACAGTCCGAC -> ACAGTCCGACA
CACATATCGGG -> ACATATCGGGT
CACATCACGCA -> ACATCACGCAA
CACCAGGTTAA -> ACCAGGTTAAC
CACCCTACCGA -> ACCCTACCGAG
CACCGTCGTAA -> ACCGTCGTAAC
CACCTTAATTC -> ACCTTAATTCA
CACGAGGGCCT -> ACGAGGGCCTC
CACGATTACTT -> ACGATTACTTA
CACGCAAGATA -> ACGCAAGATAG
CACGGAATGTG -> ACGGAATGTGC
CACGGGTCGAT -> ACGGGTCGATA
CACGTAAATCT -> ACGTAAATCTG
CACGTCAGTTG -> ACGTCAGTTGG
CACTAACGTTT -> ACTAACGTTTT
CACTACCATTG -> ACTACCATTGC
CACTACCCAGT -> ACTACCCAGTC
CACTAGGTCAG -> ACTAGGTCAGG
CACTATTACAC -> ACTATTACACG
CACTCGGCCAC -> ACTCGGCCACT
CACTCGGTTCC -> ACTCGGTTCCG
CACTCTCTTTA -> ACTCTCTTTAC
CACTGACTGCT -> ACTGACTGCTC
CACTGCACTCT -> ACTGCACTCTC
CACTGCGGCTT -> ACTGCGGCTTT
CACTGGTAGCT -> ACTGGTAGCTT
CACTGTCCCTT -> ACTGTCCCTTC
CACTGTTATCG -> ACTGTTATCGC
CACTTCACTTC -> ACTTCACTTCC
CACTTCCTCGA -> ACTTCCTCGAA
CACTTGAGTGA -> ACTTGAGTGAA
CAGAAAGCCGT -> AGAAAGCCGTA
CAGACCCGACC -> AGACCCGACCA
CAGACTTTTAG -> AGACTTTTAGT
CAGCATTGACG -> AGCATTGACGT
CAGCTGTTGTA -> AGCTGTTGTAT
CAGCTTTCCAC -> AGCTTTCCACA
CAGGAGAGTTC -> AGGAGAGTTCC
CAGGTGTCCCC -> AGGTGTCCCCG
CAGGTTAACCG -> AGGTTAACCGC
CAGTATTCTGT -> AGTATTCTGTA
CAGTCACCGTC -> AGTCACCGTCG
CAGTCCGACAA -> AGTCCGACAAT
CAGTCGGAGAT -> AGTCGGAGATC
CAGTCTTGCCA -> AGTCTTGCCAT
CAGTGAGTTGG -> AGTGAGTTGGG
CAGTGGGAGGC -> AGTGGGAGGCC
CAGTTCTTGCT -> AGTTCTTGCTG
CAGTTGCACTA -> AGTTGCACTAC
CAGTTGGCTTA -> AGTTGGCTTAG
CAGTTGGTCCA -> AGTTGGTCCAC
CATAAAGTAGT -> ATAAAGTAGTT
CATAACACGGA -> ATAACACGGAA
CATAACGACTT -> ATAACGACTTG
CATACACATCA -> ATACACATCAC
CATACCTCACT -> ATACCTCACTT
CATACGAGAAA -> ATACGAGAAAC
CATACGTGTTC -> ATACGTGTTCT
CATATCGGGTA -> ATATCGGGTAA
CATATTGCCTG -> ATATTGCCTGT
CATATTTCGTA -> ATATTTCGTAG
CATCACGCAAG -> ATCACGCAAGA
CATCCCTCAGC -> ATCCCTCAGCT
CATCCCTGTCG -> ATCCCTGTCGC
CATCGGCCCAG -> ATCGGCCCAGT
CATCGGCTATA -> ATCGGCTATAA
CATCTAGTGGA -> ATCTAGTGGAT
CATGGACCAGT -> ATGGACCAGTA
CATGTGCACTC -> ATGTGCACTCG
CATGTTCCAGA -> ATGTTCCAGAC
CATTCATCCCT -> ATTCATCCCTC
CATTCTATGTC -> ATTCTATGTCC
CATTGACGTTA -> ATTGACGTTAA
CATTGCAACAT -> ATTGCAACATC
CATTGGTATCC -> ATTGGTATCCA
CATTTATCGTA -> ATTTATCGTAC
CCAAACCATGG -> CAAACCATGGA
CCAAACTATGG -> CAAACTATGGC
CCAAATGCGCT -> CAAATGCGCTG
CCAACGACGCC -> CAACGACGCCA
CCAAGCATAAC -> CAAGCATAACG
CCAATACTCTG -> CAATACTCTGA
CCAATCGGAAG -> CAATCGGAAGG
CCAATCTGAAG -> CAATCTGAAGG
CCAATTGTATC -> CAATTGTATCT
CCACAACAACG -> CACAACAACGT
CCACAACTTCC -> CACAACTTCCG
CCACAAGACCT -> CACAAGACCTA
CCACACGTAAA -> CACACGTAAAT
CCACGGGTCGA -> CACGGGTCGAT
CCACTAACGTT -> CACTAACGTTT
CCACTATTACA -> CACTATTACAC
CCACTGACTGC -> CACTGACTGCT
CCACTTCACTT -> CACTTCACTTC
CCAGAAAGCCG -> CAGAAAGCCGT
CCAGACCCGAC -> CAGACCCGACC
CCAGACTTTTA -> CAGACTTTTAG
CCAGCATTGAC -> CAGCATTGACG
CCAGGTTAACC -> CAGGTTAACCG
CCAGTATTCTG -> CAGTATTCTGT
CCAGTCACCGT -> CAGTCACCGTC
CCAGTCTTGCC -> CAGTCTTGCCA
CCAGTGAGTTG -> CAGTGAGTTGG
CCAGTTCTTGC -> CAGTTCTTGCT
CCAGTTGCACT -> CAGTTGCACTA
CCATAAAGTAG -> CATAAAGTAGT
CCATATTTCGT -> CATATTTCGTA
CCATCCCTGTC -> CATCCCTGTCG
CCATCGGCTAT -> CATCGGCTATA
CCATGGACCAG -> CATGGACCAGT
CCATGTTCCAG -> CATGTTCCAGA
CCATTCATCCC -> CATTCATCCCT
CCATTGCAACA -> CATTGCAACAT
CCATTGGTATC -> CATTGGTATCC
CCATTTATCGT -> CATTTATCGTA
CCCAATCTGAA -> CCAATCTGAAG
CCCACAACAAC -> CCACAACAACG
CCCACGGGTCG -> CCACGGGTCGA
CCCAGTCACCG -> CCAGTCACCGT
CCCAGTCTTGC -> CCAGTCTTGCC
CCCAGTTCTTG -> CCAGTTCTTGC
CCCAGTTGCAC -> CCAGTTGCACT
CCCATAAAGTA -> CCATAAAGTAG
CCCATATTTCG -> CCATATTTCGT
CCCATTTATCG -> CCATTTATCGT
CCCCAGTTGCA -> CCCAGTTGCAC
CCCCATAAAGT -> CCCATAAAGTA
CCCCCATAAAG -> CCCCATAAAGT
CCCCGATTTGA -> CCCGATTTGAT
CCCCGTTCAAC -> CCCGTTCAACA
CCCCTGGTTAA -> CCCTGGTTAAC
CCCCTTATGTA -> CCCTTATGTAC
CCCGACCAATT -> CCGACCAATTG
CCCGATGGCAA -> CCGATGGCAAT
CCCGATTTGAT -> CCGATTTGATC
CCCGGACTAGC -> CCGGACTAGCG
CCCGGGAGCGA -> CCGGGAGCGAA
CCCGGTGACTT -> CCGGTGACTTA
CCCGTCACAGT -> CCGTCACAGTC
CCCGTGCTCAG -> CCGTGCTCAGC
CCCGTTCAACA -> CCGTTCAACAA
CCCTAAGGCAC -> CCTAAGGCACT
CCCTACCGAGG -> CCTACCGAGGC
CCCTAGCTCAA -> CCTAGCTCAAC
CCCTCAGCTGT -> CCTCAGCTGTT
CCCTCCGATGT -> CCTCCGATGTG
CCCTGGTTAAC -> CCTGGTTAACC
CCCTGTCGAGC -> CCTGTCGAGCT
CCCTGTCGCGA -> CCTGTCGCGAT
CCCTTATGTAC -> CCTTATGTACT
CCCTTCCTAGG -> CCTTCCTAGGC
CCGAATCCCGG -> CGAATCCCGGG
CCGACAATTAT -> CGACAATTATA
CCGACCAATTG -> CGACCAATTGT
CCGAGCTGACG -> CGAGCTGACGT
CCGAGCTGAGT -> CGAGCTGAGTC
CCGAGGCCCCA -> CGAGGCCCCAG
CCGAGTGGCTG -> CGAGTGGCTGC
CCGATGGCAAT -> CGATGGCAATG
CCGATGTGGCG -> CGATGTGGCGG
CCGATTGGCAT -> CGATTGGCATA
CCGATTTGATC -> CGATTTGATCC
CCGCACAAGTG -> CGCACAAGTGG
CCGCGATCTTA -> CGCGATCTTAC
CCGCGCGCCTT -> CGCGCGCCTTA
CCGCGGTGTAT -> CGCGGTGTATG
CCGCTAACCGT -> CGCTAACCGTC
CCGCTTTCGGG -> CGCTTTCGGGA
CCGGACTAGCG -> CGGACTAGCGG
CCGGATGGCGC -> CGGATGGCGCG
CCGGCGACGGC -> CGGCGACGGCG
CCGGGAAGCCG -> CGGGAAGCCGG
CCGGGAGCGAA -> CGGGAGCGAAG
CCGGTGACTTA -> CGGTGACTTAT
CCGGTTCGTGC -> CGGTTCGTGCA
CCGGTTGGGAT -> CGGTTGGGATG
CCGTAGCAATC -> CGTAGCAATCA
CCGTAGCATAC -> CGTAGCATACG
CCGTCACAGTC -> CGTCACAGTCC
CCGTCCGCGAT -> CGTCCGCGATC
CCGTCGTAACC -> CGTCGTAACCC
CCGTCGTTGTA -> CGTCGTTGTAC
CCGTGCAAGCA -> CGTGCAAGCAC
CCGTGCTCAGC -> CGTGCTCAGCT
CCGTTCAACAA -> CGTTCAACAAC
CCTAAAAGATG -> CTAAAAGATGA
CCTAAGGCACT -> CTAAGGCACTG
CCTAATTTCAT -> CTAATTTCATT
CCTACATATTG -> CTACATATTGC
CCTACCGAGGC -> CTACCGAGGCC
CCTAGCTCAAC -> CTAGCTCAACC
CCTAGGCCTGA -> CTAGGCCTGAA
CCTAGGTTGGG -> CTAGGTTGGGC
CCTCACTTGAG -> CTCACTTGAGT
CCTCAGCTGTT -> CTCAGCTGTTG
CCTCATACGAG -> CTCATACGAGA
CCTCCGATGTG -> CTCCGATGTGG
CCTCGAAAGAC -> CTCGAAAGACG
CCTCGGTACAC -> CTCGGTACACA
CCTCGTATGAT -> CTCGTATGATC
CCTCTCCCAGT -> CTCTCCCAGTT
CCTGAACACAC -> CTGAACACACT
CCTGGAACCGG -> CTGGAACCGGT
CCTGGAGACGA -> CTGGAGACGAA
CCTGGTTAACC -> CTGGTTAACCC
CCTGTATCTCA -> CTGTATCTCAC
CCTGTCGAGCT -> CTGTCGAGCTC
CCTGTCGCGAT -> CTGTCGCGATG
CCTGTGCCGAG -> CTGTGCCGAGC
CCTTAATTCAA -> CTTAATTCAAT
CCTTAATTTAA -> CTTAATTTAAA
CCTTATGTACT -> CTTATGTACTT
CCTTCCTAGGC -> CTTCCTAGGCC
CCTTGGAGTTG -> CTTGGAGTTGC
CCTTTCATACA -> CTTTCATACAC
CCTTTGCCCTA -> CTTTGCCCTAG
CGAAAAGTAGT -> GAAAAGTAGTC
CGAAAGACGAT -> GAAAGACGATC
CGAACCTCGGT -> GAACCTCGGTA
CGAACTTTGGC -> GAACTTTGGCA
CGAAGGGCGTC -> GAAGGGCGTCT
CGAAGTGAGGG -> GAAGTGAGGGA
CGAATACCACT -> GAATACCACTA
CGAATCCCGGG -> GAATCCCGGGA
CGACAATTATA -> GACAATTATAA
CGACACTGCGG -> GACACTGCGGC
CGACCAATTGT -> GACCAATTGTA
CGACGCCACAC -> GACGCCACACG
CGACGGCGAAC -> GACGGCGAACC
CGACTTGGGTT -> GACTTGGGTTA
CGAGAAACTCG -> GAGAAACTCGG
CGAGATCGAAT -> GAGATCGAATA
CGAGCTCATCG -> GAGCTCATCGG
CGAGCTGACGT -> GAGCTGACGTT
CGAGCTGAGTC -> GAGCTGAGTCA
CGAGGCCCCAG -> GAGGCCCCAGT
CGAGGGCCTCT -> GAGGGCCTCTC
CGAGTGGCTGC -> GAGTGGCTGCG
CGATAACGTAA -> GATAACGTAAC
CGATAGCTGCC -> GATAGCTGCCT
CGATCCGAGCT -> GATCCGAGCTG
CGATCTTACGG -> GATCTTACGGT
CGATGGAAATG -> GATGGAAATGA
CGATGGAGTTA -> GATGGAGTTAG
CGATGGCAATG -> GATGGCAATGA
CGATGGGTGTT -> GATGGGTGTTA
CGATGTGGCGG -> GATGTGGCGGG
CGATTACTTAA -> GATTACTTAAA
CGATTGGCATA -> GATTGGCATAC
CGATTTGATCC -> GATTTGATCCT
CGCAAATTAGT -> GCAAATTAGTA
CGCAACGCACT -> GCAACGCACTA
CGCAAGATAGT -> GCAAGATAGTG
CGCACAAGTGG -> GCACAAGTGGG
CGCACTAGGTC -> GCACTAGGTCA
CGCCACACGTA -> GCCACACGTAA
CGCCATCCCTG -> GCCATCCCTGT
CGCCATGTTCC -> GCCATGTTCCA
CGCCCACGGGT -> GCCCACGGGTC
CGCCCATATTT -> GCCCATATTTC
CGCCCTGTCGA -> GCCCTGTCGAG
CGCCGATTGGC -> GCCGATTGGCA
CGCCTGGAGAC -> GCCTGGAGACG
CGCCTTAATTT -> GCCTTAATTTA
CGCGATCTTAC -> GCGATCTTACG
CGCGATGGAAA -> GCGATGGAAAT
CGCGCCTTAAT -> GCGCCTTAATT
CGCGCGCCTTA -> GCGCGCCTTAA
CGCGCTCGGTA -> GCGCTCGGTAC
CGCGCTTACCC -> GCGCTTACCCA
CGCGGCTCCTT -> GCGGCTCCTTT
CGCGGTGTATG -> GCGGTGTATGA
CGCGTCCAGCA -> GCGTCCAGCAT
CGCGTCCGGGA -> GCGTCCGGGAA
CGCTAACCGTC -> GCTAACCGTCG
CGCTCGGTACT -> GCTCGGTACTG
CGCTGGCTCCG -> GCTGGCTCCGG
CGCTTACCCAC -> GCTTACCCACA
CGCTTTCGGGA -> GCTTTCGGGAA
CGGAAGGCGGT -> GGAAGGCGGTT
CGGAAGGGCTA -> GGAAGGGCTAT
CGGAATGTGCG -> GGAATGTGCGC
CGGACTAGCGG -> GGACTAGCGGC
CGGAGATCCGC -> GGAGATCCGCT
CGGATCACACT -> GGATCACACTG
CGGATGGCGCG -> GGATGGCGCGT
CGGCCACTGAC -> GGCCACTGACT
CGGCCCAGTCA -> GGCCCAGTCAC
CGGCGAACCTC -> GGCGAACCTCG
CGGCGACGGCG -> GGCGACGGCGA
CGGCTATAACC -> GGCTATAACCA
CGGCTCCTTTG -> GGCTCCTTTGC
CGGCTTTCGGT -> GGCTTTCGGTT
CGGCTTTGCTA -> GGCTTTGCTAA
CGGGAAGCCGG -> GGGAAGCCGGA
CGGGAATTAAA -> GGGAATTAAAG
CGGGAATTTTC -> GGGAATTTTCC
CGGGAGCGAAG -> GGGAGCGAAGG
CGGGCCTCGTA -> GGGCCTCGTAT
CGGGGTCACCA -> GGGGTCACCAG
CGGGTAAGAGG -> GGGTAAGAGGA
CGGGTCGATAG -> GGGTCGATAGC
CGGTACACAAA -> GGTACACAAAG
CGGTACTGCGC -> GGTACTGCGCG
CGGTACTTCAA -> GGTACTTCAAG
CGGTGACTTAT -> GGTGACTTATG
CGGTGAGATAG -> GGTGAGATAGC
CGGTGGTAGTG -> GGTGGTAGTGT
CGGTGTATGAG -> GGTGTATGAGC
CGGTTAATGTA -> GGTTAATGTAG
CGGTTCCGCAC -> GGTTCCGCACA
CGGTTCGCCCA -> GGTTCGCCCAT
CGGTTCGTGCA -> GGTTCGTGCAA
CGGTTGGGATG -> GGTTGGGATGA
CGGTTGTATGT -> GGTTGTATGTT
CGTAAACGGTA -> GTAAACGGTAC
CGTAAATCTGA -> GTAAATCTGAG
CGTAACCCAAT -> GTAACCCAATC
CGTAACGGAAG -> GTAACGGAAGG
CGTACGCCCAC -> GTACGCCCACG
CGTAGAATTGT -> GTAGAATTGTA
CGTAGCAATCA -> GTAGCAATCAG
CGTAGCATACG -> GTAGCATACGT
CGTATCTACCA -> GTATCTACCAA
CGTATCTCCTT -> GTATCTCCTTG
CGTATGATCGA -> GTATGATCGAT
CGTCACAGTCC -> GTCACAGTCCG
CGTCAGTTGGC -> GTCAGTTGGCT
CGTCCAGCATT -> GTCCAGCATTG
CGTCCGCGATC -> GTCCGCGATCT
CGTCCGGGAAG -> GTCCGGGAAGC
CGTCGATAACG -> GTCGATAACGT
CGTCGTAACCC -> GTCGTAACCCA
CGTCGTTGTAC -> GTCGTTGTACG
CGTCTTACGAA -> GTCTTACGAAA
CGTGAGTGAAG -> GTGAGTGAAGC
CGTGCAAAGTT -> GTGCAAAGTTT
CGTGCAAGCAC -> GTGCAAGCACG
CGTGCTCAGCT -> GTGCTCAGCTT
CGTGTTCTAAT -> GTGTTCTAATA
CGTTAACACCT -> GTTAACACCTT
CGTTCAACAAC -> GTTCAACAACT
CGTTGTACGTA -> GTTGTACGTAT
CGTTGTCTCGA -> GTTGTCTCGAG
CGTTTTAGAAA -> GTTTTAGAAAG
CTAAAAGATGA -> TAAAAGATGAC
CTAACCGTCGT -> TAACCGTCGTT
CTAACGTTTTA -> TAACGTTTTAG
CTAAGGCACTG -> TAAGGCACTGT
CTAATACCGTC -> TAATACCGTCC
CTAATTCACTG -> TAATTCACTGT
CTAATTTCATT -> TAATTTCATTC
CTACATATTGC -> TACATATTGCC
CTACCAAATGC -> TACCAAATGCG
CTACCAATACT -> TACCAATACTC
CTACCATTGCA -> TACCATTGCAA
CTACCCAGTCT -> TACCCAGTCTT
CTACCCGTGCT -> TACCCGTGCTC
CTACCGAGGCC -> TACCGAGGCCC
CTAGCGCCATG -> TAGCGCCATGT
CTAGCGGCTTT -> TAGCGGCTTTC
CTAGCTCAACC -> TAGCTCAACCA
CTAGGCCTGAA -> TAGGCCTGAAC
CTAGGTCAGGT -> TAGGTCAGGTG
CTAGGTTGGGC -> TAGGTTGGGCG
CTAGTGGATCC -> TAGTGGATCCG
CTATAACCACT -> TATAACCACTA
CTATAGTTGGA -> TATAGTTGGAT
CTATGGCCAAA -> TATGGCCAAAC
CTATGGGACCT -> TATGGGACCTA
CTATGTCCGCG -> TATGTCCGCGC
CTATTACACGT -> TATTACACGTC
CTATTCTCACG -> TATTCTCACGA
CTCAACCAAGC -> TCAACCAAGCA
CTCACATATCG -> TCACATATCGG
CTCACGAGGGC -> TCACGAGGGCC
CTCACTTGAGT -> TCACTTGAGTG
CTCAGCTGTTG -> TCAGCTGTTGT
CTCAGCTTTCC -> TCAGCTTTCCA
CTCATACGAGA -> TCATACGAGAA
CTCATCGGCCC -> TCATCGGCCCA
CTCCAAACTAT -> TCCAAACTATG
CTCCATTGGTA -> TCCATTGGTAT
CTCCCAGTTCT -> TCCCAGTTCTT
CTCCGATGTGG -> TCCGATGTGGC
CTCCGGTTCGT -> TCCGGTTCGTG
CTCCTGTGCCG -> TCCTGTGCCGA
CTCCTTGGAGT -> TCCTTGGAGTT
CTCCTTTCATA -> TCCTTTCATAC
CTCCTTTGCCC -> TCCTTTGCCCT
CTCGAAAGACG -> TCGAAAGACGA
CTCGAGATCGA -> TCGAGATCGAA
CTCGGCCACTG -> TCGGCCACTGA
CTCGGTACACA -> TCGGTACACAA
CTCGGTACTGC -> TCGGTACTGCG
CTCGGTGAGAT -> TCGGTGAGATA
CTCGGTTCCGC -> TCGGTTCCGCA
CTCGTATGATC -> TCGTATGATCG
CTCTACCCGTG -> TCTACCCGTGC
CTCTCCCAGTT -> TCTCCCAGTTC
CTCTCCTTTCA -> TCTCCTTTCAT
CTCTCTACCCG -> TCTCTACCCGT
CTCTCTGCCGA -> TCTCTGCCGAG
CTCTCTTTACG -> TCTCTTTACGC
CTCTGAAGTCT -> TCTGAAGTCTC
CTCTGCCGAGT -> TCTGCCGAGTG
CTCTTTACGCC -> TCTTTACGCCT
CTGAACACACT -> TGAACACACTG
CTGAAGGGCGT -> TGAAGGGCGTC
CTGAAGTCTCC -> TGAAGTCTCCA
CTGACGTTGTC -> TGACGTTGTCT
CTGACTGCTCC -> TGACTGCTCCT
CTGAGGTAGGA -> TGAGGTAGGAA
CTGAGTCACCC -> TGAGTCACCCT
CTGCACTCTCT -> TGCACTCTCTT
CTGCCGAGTGG -> TGCCGAGTGGC
CTGCCTGGAAC -> TGCCTGGAACC
CTGCGATGGAG -> TGCGATGGAGT
CTGCGCGTCCG -> TGCGCGTCCGG
CTGCGGCTTTG -> TGCGGCTTTGC
CTGCGGTTGTA -> TGCGGTTGTAT
CTGCTCCTGTG -> TGCTCCTGTGC
CTGGAACCGGT -> TGGAACCGGTT
CTGGAGACGAA -> TGGAGACGAAG
CTGGCTCCGGT -> TGGCTCCGGTT
CTGGGCCAATC -> TGGGCCAATCG
CTGGTAGCTTG -> TGGTAGCTTGG
CTGGTGCGCGC -> TGGTGCGCGCT
CTGGTTAACCC -> TGGTTAACCCG
CTGTACTTAAG -> TGTACTTAAGT
CTGTATCTCAC -> TGTATCTCACA
CTGTCCCTTCC -> TGTCCCTTCCT
CTGTCGAGCTC -> TGTCGAGCTCA
CTGTCGCGATG -> TGTCGCGATGG
CTGTGCCGAGC -> TGTGCCGAGCT
CTGTTATCGCG -> TGTTATCGCGG
CTGTTGTATTA -> TGTTGTATTAA
CTTAAATTAGG -> TTAAATTAGGA
CTTAAGTCTCT -> TTAAGTCTCTC
CTTAATTCAAT -> TTAATTCAATT
CTTAATTTAAA -> TTAATTTAAAA
CTTACCCACAA -> TTACCCACAAC
CTTACGAAAAG -> TTACGAAAAGT
CTTACGGTGGT -> TTACGGTGGTA
CTTAGACCCCT -> TTAGACCCCTG
CTTAGCCCGTC -> TTAGCCCGTCA
CTTATGTAACG -> TTATGTAACGG
CTTATGTACTT -> TTATGTACTTG
CTTCAAGTGAC -> TTCAAGTGACG
CTTCACTTCCT -> TTCACTTCCTC
CTTCAGTCGGA -> TTCAGTCGGAG
CTTCCGCTAAC -> TTCCGCTAACC
CTTCCTAGGCC -> TTCCTAGGCCT
CTTCCTCGAAA -> TTCCTCGAAAG
CTTGACTAGCG -> TTGACTAGCGC
CTTGAGTGAAT -> TTGAGTGAATC
CTTGATTGGAC -> TTGATTGGACT
CTTGCCATCGG -> TTGCCATCGGC
CTTGCTGCGAT -> TTGCTGCGATG
CTTGGACTTCA -> TTGGACTTCAG
CTTGGAGTTGC -> TTGGAGTTGCT
CTTGGGCCACA -> TTGGGCCACAA
CTTGGGTTAGG -> TTGGGTTAGGT
CTTTACGCCTG -> TTTACGCCTGG
CTTTCATACAC -> TTTCATACACA
CTTTCCACAAC -> TTTCCACAACT
CTTTCGGGAAT -> TTTCGGGAATT
CTTTCGGTTCG -> TTTCGGTTCGC
CTTTGCCCTAG -> TTTGCCCTAGC
CTTTGCTAATT -> TTTGCTAATTC
CTTTGGCAAAC -> TTTGGCAAACG
CTTTTAGTCCG -> TTTTAGTCCGG
GAAAAGTAGTC -> AAAAGTAGTCG
GAAACCAGACC -> AAACCAGACCC
GAAACTCGGTG -> AAACTCGGTGA
GAAAGAATGTT -> AAAGAATGTTT
GAAAGACGATC -> AAAGACGATCC
GAAAGCCCCCA -> AAAGCCCCCAT
GAAAGCCGTAG -> AAAGCCGTAGC
GAAATGATCAA -> AAATGATCAAG
GAAATGCCCAT -> AAATGCCCATT
GAACACACTGC -> AACACACTGCA
GAACCGGTTGG -> AACCGGTTGGG
GAACCTAATTT -> AACCTAATTTC
GAACCTCGGTA -> AACCTCGGTAC
GAACTTTGGCA -> AACTTTGGCAA
GAAGACAAATA -> AAGACAAATAG
GAAGCCGGATG -> AAGCCGGATGG
GAAGCGCAACG -> AAGCGCAACGC
GAAGGCGGTTA -> AAGGCGGTTAA
GAAGGGCGTCG -> AAGGGCGTCGA
GAAGGGCGTCT -> AAGGGCGTCTT
GAAGGGCTATT -> AAGGGCTATTC
GAAGTCTCCAA -> AAGTCTCCAAA
GAAGTGAGGGA -> AAGTGAGGGAT
GAAGTTTACTT -> AAGTTTACTTA
GAATACCACTA -> AATACCACTAA
GAATCAAGCCC -> AATCAAGCCCG
GAATCCCGGGA -> AATCCCGGGAG
GAATGTGCGCC -> AATGTGCGCCA
GAATGTTTGTC -> AATGTTTGTCC
GAATTAAAGAA -> AATTAAAGAAC
GAATTGTATAA -> AATTGTATAAT
GAATTTTCCCT -> AATTTTCCCTC
GACAAATAGGA -> ACAAATAGGAA
GACAATTATAA -> ACAATTATAAT
GACACTGCGGC -> ACACTGCGGCT
GACCAACGACG -> ACCAACGACGC
GACCAATTGTA -> ACCAATTGTAT
GACCAGTATTC -> ACCAGTATTCT
GACCCCGATTT -> ACCCCGATTTG
GACCCCTGGTT -> ACCCCTGGTTA
GACCCGACCAA -> ACCCGACCAAT
GACCGTGCAAG -> ACCGTGCAAGC
GACCTAAAAGA -> ACCTAAAAGAT
GACCTAGGTTG -> ACCTAGGTTGG
GACGAAGTGAG -> ACGAAGTGAGG
GACGATCCGAG -> ACGATCCGAGC
GACGCCACACG -> ACGCCACACGT
GACGCCCTGTC -> ACGCCCTGTCG
GACGGCGAACC -> ACGGCGAACCT
GACGTGAGTGA -> ACGTGAGTGAA
GACGTTAACAC -> ACGTTAACACC
GACGTTGTCTC -> ACGTTGTCTCG
GACTAGCGCCA -> ACTAGCGCCAT
GACTAGCGGCT -> ACTAGCGGCTT
GACTGCTCCTG -> ACTGCTCCTGT
GACTGGGCCAA -> ACTGGGCCAAT
GACTTATGTAA -> ACTTATGTAAC
GACTTCAGTCG -> ACTTCAGTCGG
GACTTGGGTTA -> ACTTGGGTTAG
GACTTTTAGTC -> ACTTTTAGTCC
GAGAAACTCGG -> AGAAACTCGGT
GAGACCAACGA -> AGACCAACGAC
GAGACGAAGTG -> AGACGAAGTGA
GAGAGTAAACA -> AGAGTAAACAC
GAGAGTTCCCG -> AGAGTTCCCGG
GAGATAGCGCC -> AGATAGCGCCG
GAGATCCGCTT -> AGATCCGCTTT
GAGATCGAATA -> AGATCGAATAC
GAGCGAAGGGC -> AGCGAAGGGCG
GAGCGTATCTA -> AGCGTATCTAC
GAGCTCATCGG -> AGCTCATCGGC
GAGCTGACGTT -> AGCTGACGTTG
GAGCTGAGTCA -> AGCTGAGTCAC
GAGGATAAAGG -> AGGATAAAGGC
GAGGCCCCAGT -> AGGCCCCAGTT
GAGGCCCTAAG -> AGGCCCTAAGG
GAGGGATCATG -> AGGGATCATGT
GAGGGCCTCTC -> AGGGCCTCTCC
GAGGTAGGAAA -> AGGTAGGAAAC
GAGTAAACACT -> AGTAAACACTA
GAGTCACCCTA -> AGTCACCCTAC
GAGTGAAGCGC -> AGTGAAGCGCA
GAGTGAATCAA -> AGTGAATCAAG
GAGTGGCTGCG -> AGTGGCTGCGG
GAGTTAGCACA -> AGTTAGCACAG
GAGTTCCCGGA -> AGTTCCCGGAC
GAGTTGCTATA -> AGTTGCTATAG
GAGTTGGGGAC -> AGTTGGGGACC
GATAAAGGCCG -> ATAAAGGCCGT
GATAACGTAAC -> ATAACGTAACG
GATAGAAAGCC -> ATAGAAAGCCC
GATAGCGCCGA -> ATAGCGCCGAT
GATAGCTGCCT -> ATAGCTGCCTG
GATAGTGTGGA -> ATAGTGTGGAT
GATATTCGCGC -> ATATTCGCGCT
GATCAAGAAGT -> ATCAAGAAGTT
GATCACACTGG -> ATCACACTGGT
GATCATGTGCA -> ATCATGTGCAC
GATCCGAATCC -> ATCCGAATCCC
GATCCGAGCTG -> ATCCGAGCTGA
GATCCGCTTTC -> ATCCGCTTTCG
GATCCTACATA -> ATCCTACATAT
GATCGAATACC -> ATCGAATACCA
GATCGATGGGT -> ATCGATGGGTG
GATCTTACGGT -> ATCTTACGGTG
GATGACCGTGC -> ATGACCGTGCA
GATGACGTGAG -> ATGACGTGAGT
GATGATAGAAA -> ATGATAGAAAG
GATGCACTCGG -> ATGCACTCGGC
GATGGAAATGA -> ATGGAAATGAT
GATGGAGTTAG -> ATGGAGTTAGC
GATGGCAATGA -> ATGGCAATGAA
GATGGCGCGTC -> ATGGCGCGTCC
GATGGGTGTTA -> ATGGGTGTTAT
GATGTGGCGGG -> ATGTGGCGGGA
GATTACTTAAA -> ATTACTTAAAT
GATTGGACTGG -> ATTGGACTGGG
GATTGGCATAC -> ATTGGCATACC
GATTTGATCCT -> ATTTGATCCTA
GCAAACGACAC -> CAAACGACACT
GCAAAGTTTCT -> CAAAGTTTCTA
GCAAATTAGTA -> CAAATTAGTAA
GCAACATCTAG -> CAACATCTAGT
GCAACGCACTA -> CAACGCACTAG
GCAAGATAGTG -> CAAGATAGTGT
GCAAGATATTC -> CAAGATATTCG
GCAAGCACGAT -> CAAGCACGATT
GCAATCAGTTG -> CAATCAGTTGG
GCAATGAAGAC -> CAATGAAGACA
GCACAAGTGGG -> CACAAGTGGGG
GCACAGGAGAG -> CACAGGAGAGT
GCACGATTACT -> CACGATTACTT
GCACTACCATT -> CACTACCATTG
GCACTAGGTCA -> CACTAGGTCAG
GCACTCGGCCA -> CACTCGGCCAC
GCACTCGGTTC -> CACTCGGTTCC
GCACTCTCTTT -> CACTCTCTTTA
GCACTGTCCCT -> CACTGTCCCTT
GCATAACACGG -> CATAACACGGA
GCATAACGACT -> CATAACGACTT
GCATACCTCAC -> CATACCTCACT
GCATACGTGTT -> CATACGTGTTC
GCATTGACGTT -> CATTGACGTTA
GCCAAACCATG -> CCAAACCATGG
GCCAATCGGAA -> CCAATCGGAAG
GCCACAAGACC -> CCACAAGACCT
GCCACACGTAA -> CCACACGTAAA
GCCACTGACTG -> CCACTGACTGC
GCCATCCCTGT -> CCATCCCTGTC
GCCATCGGCTA -> CCATCGGCTAT
GCCATGTTCCA -> CCATGTTCCAG
GCCCACGGGTC -> CCCACGGGTCG
GCCCAGTCACC -> CCCAGTCACCG
GCCCATATTTC -> CCCATATTTCG
GCCCATTTATC -> CCCATTTATCG
GCCCCAGTTGC -> CCCCAGTTGCA
GCCCCCATAAA -> CCCCCATAAAG
GCCCGGTGACT -> CCCGGTGACTT
GCCCGTCACAG -> CCCGTCACAGT
GCCCTAAGGCA -> CCCTAAGGCAC
GCCCTAGCTCA -> CCCTAGCTCAA
GCCCTGTCGAG -> CCCTGTCGAGC
GCCGAGCTGAC -> CCGAGCTGACG
GCCGAGTGGCT -> CCGAGTGGCTG
GCCGATTGGCA -> CCGATTGGCAT
GCCGGATGGCG -> CCGGATGGCGC
GCCGTAGCAAT -> CCGTAGCAATC
GCCGTAGCATA -> CCGTAGCATAC
GCCTCGTATGA -> CCTCGTATGAT
GCCTCTCCCAG -> CCTCTCCCAGT
GCCTGAACACA -> CCTGAACACAC
GCCTGGAACCG -> CCTGGAACCGG
GCCTGGAGACG -> CCTGGAGACGA
GCCTGTATCTC -> CCTGTATCTCA
GCCTTAATTTA -> CCTTAATTTAA
GCGAACCTCGG -> CGAACCTCGGT
GCGAAGGGCGT -> CGAAGGGCGTC
GCGACGGCGAA -> CGACGGCGAAC
GCGATCTTACG -> CGATCTTACGG
GCGATGGAAAT -> CGATGGAAATG
GCGATGGAGTT -> CGATGGAGTTA
GCGCAAATTAG -> CGCAAATTAGT
GCGCAACGCAC -> CGCAACGCACT
GCGCCATCCCT -> CGCCATCCCTG
GCGCCATGTTC -> CGCCATGTTCC
GCGCCGATTGG -> CGCCGATTGGC
GCGCCTTAATT -> CGCCTTAATTT
GCGCGCCTTAA -> CGCGCCTTAAT
GCGCGCTCGGT -> CGCGCTCGGTA
GCGCGTCCAGC -> CGCGTCCAGCA
GCGCGTCCGGG -> CGCGTCCGGGA
GCGCTCGGTAC -> CGCTCGGTACT
GCGCTGGCTCC -> CGCTGGCTCCG
GCGCTTACCCA -> CGCTTACCCAC
GCGGCTCCTTT -> CGGCTCCTTTG
GCGGCTTTCGG -> CGGCTTTCGGT
GCGGCTTTGCT -> CGGCTTTGCTA
GCGGGAATTAA -> CGGGAATTAAA
GCGGTGTATGA -> CGGTGTATGAG
GCGGTTAATGT -> CGGTTAATGTA
GCGGTTGTATG -> CGGTTGTATGT
GCGTATCTACC -> CGTATCTACCA
GCGTCCAGCAT -> CGTCCAGCATT
GCGTCCGGGAA -> CGTCCGGGAAG
GCGTCGATAAC -> CGTCGATAACG
GCGTCTTACGA -> CGTCTTACGAA
GCTAACCGTCG -> CTAACCGTCGT
GCTAATTCACT -> CTAATTCACTG
GCTATAACCAC -> CTATAACCACT
GCTATAGTTGG -> CTATAGTTGGA
GCTATTCTCAC -> CTATTCTCACG
GCTCAACCAAG -> CTCAACCAAGC
GCTCAGCTTTC -> CTCAGCTTTCC
GCTCATCGGCC -> CTCATCGGCCC
GCTCCATTGGT -> CTCCATTGGTA
GCTCCGGTTCG -> CTCCGGTTCGT
GCTCCTGTGCC -> CTCCTGTGCCG
GCTCCTTTGCC -> CTCCTTTGCCC
GCTCGGTACTG -> CTCGGTACTGC
GCTGACGTTGT -> CTGACGTTGTC
GCTGAGTCACC -> CTGAGTCACCC
GCTGCCTGGAA -> CTGCCTGGAAC
GCTGCGATGGA -> CTGCGATGGAG
GCTGCGGTTGT -> CTGCGGTTGTA
GCTGGCTCCGG -> CTGGCTCCGGT
GCTGGTGCGCG -> CTGGTGCGCGC
GCTGTTGTATT -> CTGTTGTATTA
GCTTACCCACA -> CTTACCCACAA
GCTTAGACCCC -> CTTAGACCCCT
GCTTGGGCCAC -> CTTGGGCCACA
GCTTTCCACAA -> CTTTCCACAAC
GCTTTCGGGAA -> CTTTCGGGAAT
GCTTTCGGTTC -> CTTTCGGTTCG
GCTTTGCTAAT -> CTTTGCTAATT
GGAAACCAGAC -> GAAACCAGACC
GGAAATGATCA -> GAAATGATCAA
GGAAATGCCCA -> GAAATGCCCAT
GGAACCGGTTG -> GAACCGGTTGG
GGAAGCCGGAT -> GAAGCCGGATG
GGAAGGCGGTT -> GAAGGCGGTTA
GGAAGGGCTAT -> GAAGGGCTATT
GGAATGTGCGC -> GAATGTGCGCC
GGAATTAAAGA -> GAATTAAAGAA
GGAATTTTCCC -> GAATTTTCCCT
GGACCAGTATT -> GACCAGTATTC
GGACCCCGATT -> GACCCCGATTT
GGACCTAGGTT -> GACCTAGGTTG
GGACTAGCGGC -> GACTAGCGGCT
GGACTGGGCCA -> GACTGGGCCAA
GGACTTCAGTC -> GACTTCAGTCG
GGAGACCAACG -> GAGACCAACGA
GGAGACGAAGT -> GAGACGAAGTG
GGAGAGTTCCC -> GAGAGTTCCCG
GGAGATCCGCT -> GAGATCCGCTT
GGAGCGAAGGG -> GAGCGAAGGGC
GGAGGCCCTAA -> GAGGCCCTAAG
GGAGTTAGCAC -> GAGTTAGCACA
GGAGTTGCTAT -> GAGTTGCTATA
GGATAAAGGCC -> GATAAAGGCCG
GGATCACACTG -> GATCACACTGG
GGATCATGTGC -> GATCATGTGCA
GGATCCGAATC -> GATCCGAATCC
GGATGACGTGA -> GATGACGTGAG
GGATGATAGAA -> GATGATAGAAA
GGATGCACTCG -> GATGCACTCGG
GGATGGCGCGT -> GATGGCGCGTC
GGCAAACGACA -> GCAAACGACAC
GGCAATGAAGA -> GCAATGAAGAC
GGCACTGTCCC -> GCACTGTCCCT
GGCATACCTCA -> GCATACCTCAC
GGCCAAACCAT -> GCCAAACCATG
GGCCAATCGGA -> GCCAATCGGAA
GGCCACAAGAC -> GCCACAAGACC
GGCCACTGACT -> GCCACTGACTG
GGCCCAGTCAC -> GCCCAGTCACC
GGCCCCAGTTG -> GCCCCAGTTGC
GGCCCTAAGGC -> GCCCTAAGGCA
GGCCGTAGCAT -> GCCGTAGCATA
GGCCTCGTATG -> GCCTCGTATGA
GGCCTCTCCCA -> GCCTCTCCCAG
GGCCTGAACAC -> GCCTGAACACA
GGCGAACCTCG -> GCGAACCTCGG
GGCGACGGCGA -> GCGACGGCGAA
GGCGCAAATTA -> GCGCAAATTAG
GGCGCGTCCAG -> GCGCGTCCAGC
GGCGGGAATTA -> GCGGGAATTAA
GGCGGTTAATG -> GCGGTTAATGT
GGCGTCGATAA -> GCGTCGATAAC
GGCGTCTTACG -> GCGTCTTACGA
GGCTATAACCA -> GCTATAACCAC
GGCTATTCTCA -> GCTATTCTCAC
GGCTCCGGTTC -> GCTCCGGTTCG
GGCTCCTTTGC -> GCTCCTTTGCC
GGCTGCGGTTG -> GCTGCGGTTGT
GGCTGGTGCGC -> GCTGGTGCGCG
GGCTTAGACCC -> GCTTAGACCCC
GGCTTTCGGTT -> GCTTTCGGTTC
GGCTTTGCTAA -> GCTTTGCTAAT
GGGAAGCCGGA -> GGAAGCCGGAT
GGGAATTAAAG -> GGAATTAAAGA
GGGAATTTTCC -> GGAATTTTCCC
GGGACCCCGAT -> GGACCCCGATT
GGGACCTAGGT -> GGACCTAGGTT
GGGAGCGAAGG -> GGAGCGAAGGG
GGGAGGCCCTA -> GGAGGCCCTAA
GGGATCATGTG -> GGATCATGTGC
GGGATGACGTG -> GGATGACGTGA
GGGCCAATCGG -> GGCCAATCGGA
GGGCCACAAGA -> GGCCACAAGAC
GGGCCTCGTAT -> GGCCTCGTATG
GGGCCTCTCCC -> GGCCTCTCCCA
GGGCGCAAATT -> GGCGCAAATTA
GGGCGTCGATA -> GGCGTCGATAA
GGGCGTCTTAC -> GGCGTCTTACG
GGGCTATTCTC -> GGCTATTCTCA
GGGGACCCCGA -> GGGACCCCGAT
GGGGTCACCAG -> GGGTCACCAGG
GGGGTCTCTCC -> GGGTCTCTCCT
GGGTAAGAGGA -> GGTAAGAGGAT
GGGTCACCAGG -> GGTCACCAGGT
GGGTCGATAGC -> GGTCGATAGCT
GGGTCTCTCCT -> GGTCTCTCCTT
GGGTGTTATAT -> GGTGTTATATC
GGGTTAGGTAT -> GGTTAGGTATC
GGTAAGAGGAT -> GTAAGAGGATA
GGTACACAAAG -> GTACACAAAGC
GGTACTGCGCG -> GTACTGCGCGT
GGTACTTCAAG -> GTACTTCAAGT
GGTAGCTTGGG -> GTAGCTTGGGC
GGTAGGAAACC -> GTAGGAAACCA
GGTAGTGTCCA -> GTAGTGTCCAG
GGTATCCATTC -> GTATCCATTCA
GGTATCTACCA -> GTATCTACCAA
GGTATTCCTCA -> GTATTCCTCAT
GGTCACCAGGT -> GTCACCAGGTT
GGTCAGGTGTC -> GTCAGGTGTCC
GGTCCACTTCA -> GTCCACTTCAC
GGTCGATAGCT -> GTCGATAGCTG
GGTCTCTCCTT -> GTCTCTCCTTT
GGTGACTTATG -> GTGACTTATGT
GGTGAGATAGC -> GTGAGATAGCG
GGTGCGCGCTC -> GTGCGCGCTCG
GGTGGTAGTGT -> GTGGTAGTGTC
GGTGTATGAGC -> GTGTATGAGCG
GGTGTCCCCGT -> GTGTCCCCGTT
GGTGTTATATC -> GTGTTATATCT
GGTTAACCCGA -> GTTAACCCGAT
GGTTAACCGCG -> GTTAACCGCGG
GGTTAATGTAG -> GTTAATGTAGT
GGTTAGGTATC -> GTTAGGTATCT
GGTTCCGCACA -> GTTCCGCACAA
GGTTCGCCCAT -> GTTCGCCCATA
GGTTCGTGCAA -> GTTCGTGCAAA
GGTTGGGATGA -> GTTGGGATGAC
GGTTGGGCGCA -> GTTGGGCGCAA
GGTTGTATGTT -> GTTGTATGTTC
GTAAACACTAC -> TAAACACTACC
GTAAACGGTAC -> TAAACGGTACT
GTAAAGGTATT -> TAAAGGTATTC
GTAAATCTGAG -> TAAATCTGAGG
GTAACCCAATC -> TAACCCAATCT
GTAACGGAAGG -> TAACGGAAGGG
GTAACGGATCA -> TAACGGATCAC
GTAAGAGGATA -> TAAGAGGATAA
GTACACAAAGC -> TACACAAAGCT
GTACGCCCACG -> TACGCCCACGG
GTACGTATCTC -> TACGTATCTCC
GTACTGCGCGT -> TACTGCGCGTC
GTACTTAAGTC -> TACTTAAGTCT
GTACTTCAAGT -> TACTTCAAGTG
GTACTTGACTA -> TACTTGACTAG
GTAGAATTGTA -> TAGAATTGTAT
GTAGCAATCAG -> TAGCAATCAGT
GTAGCATACGT -> TAGCATACGTG
GTAGCTTGGGC -> TAGCTTGGGCC
GTAGGAAACCA -> TAGGAAACCAG
GTAGGCTGGTG -> TAGGCTGGTGC
GTAGTAGGCTG -> TAGTAGGCTGG
GTAGTCGAACT -> TAGTCGAACTT
GTAGTGTCCAG -> TAGTGTCCAGA
GTAGTTTGCAT -> TAGTTTGCATA
GTATAATCCAG -> TATAATCCAGT
GTATCCATTCA -> TATCCATTCAT
GTATCTACCAA -> TATCTACCAAA,TATCTACCAAT
GTATCTCACAT -> TATCTCACATA
GTATCTCCTTG -> TATCTCCTTGG
GTATCTTGATT -> TATCTTGATTG
GTATGAGCGTA -> TATGAGCGTAT
GTATGATCGAT -> TATGATCGATG
GTATGTTCAGT -> TATGTTCAGTG
GTATTAACAGG -> TATTAACAGGT
GTATTCCTCAT -> TATTCCTCATA
GTATTCTGTAC -> TATTCTGTACT
GTCACAGTCCG -> TCACAGTCCGA
GTCACCAGGTT -> TCACCAGGTTA
GTCACCCTACC -> TCACCCTACCG
GTCACCGTCGT -> TCACCGTCGTA
GTCAGGTGTCC -> TCAGGTGTCCC
GTCAGTTGGCT -> TCAGTTGGCTT
GTCCACTTCAC -> TCCACTTCACT
GTCCAGAAAGC -> TCCAGAAAGCC
GTCCAGCATTG -> TCCAGCATTGA
GTCCCCGTTCA -> TCCCCGTTCAA
GTCCCCTTATG -> TCCCCTTATGT
GTCCCTTCCTA -> TCCCTTCCTAG
GTCCGACAATT -> TCCGACAATTA
GTCCGCGATCT -> TCCGCGATCTT
GTCCGCGCGCC -> TCCGCGCGCCT
GTCCGGCGACG -> TCCGGCGACGG
GTCCGGGAAGC -> TCCGGGAAGCC
GTCGAACTTTG -> TCGAACTTTGG
GTCGAGCTCAT -> TCGAGCTCATC
GTCGATAACGT -> TCGATAACGTA
GTCGATAGCTG -> TCGATAGCTGC
GTCGCGATGGA -> TCGCGATGGAA
GTCGGAGATCC -> TCGGAGATCCG
GTCGTAACCCA -> TCGTAACCCAA
GTCGTTGTACG -> TCGTTGTACGT
GTCTCCAAACT -> TCTCCAAACTA
GTCTCGAGATC -> TCTCGAGATCG
GTCTCTCCTTT -> TCTCTCCTTTC
GTCTCTCTGCC -> TCTCTCTGCCG
GTCTTACGAAA -> TCTTACGAAAA
GTCTTGCCATC -> TCTTGCCATCG
GTGAAGCGCAA -> TGAAGCGCAAC
GTGAATCAAGC -> TGAATCAAGCC
GTGACGCCCTG -> TGACGCCCTGT
GTGACTTATGT -> TGACTTATGTA
GTGAGATAGCG -> TGAGATAGCGC
GTGAGGGATCA -> TGAGGGATCAT
GTGAGTGAAGC -> TGAGTGAAGCG
GTGAGTTGGGG -> TGAGTTGGGGA
GTGCAAAGTTT -> TGCAAAGTTTC
GTGCAAGCACG -> TGCAAGCACGA
GTGCACTCGGT -> TGCACTCGGTT
GTGCCGAGCTG -> TGCCGAGCTGA
GTGCGCCATCC -> TGCGCCATCCC
GTGCGCGCTCG -> TGCGCGCTCGG
GTGCTCAGCTT -> TGCTCAGCTTT
GTGGATCCGAA -> TGGATCCGAAT
GTGGATGATAG -> TGGATGATAGA
GTGGCGGGAAT -> TGGCGGGAATT
GTGGCTGCGGT -> TGGCTGCGGTT
GTGGGAGGCCC -> TGGGAGGCCCT
GTGGGGTCTCT -> TGGGGTCTCTC
GTGGTAGTGTC -> TGGTAGTGTCC
GTGTATGAGCG -> TGTATGAGCGT
GTGTCCAGAAA -> TGTCCAGAAAG
GTGTCCCCGTT -> TGTCCCCGTTC
GTGTGGATGAT -> TGTGGATGATA
GTGTTATATCT -> TGTTATATCTT
GTGTTCTAATA -> TGTTCTAATAC
GTTAACACCTT -> TTAACACCTTA
GTTAACCCGAT -> TTAACCCGATG
GTTAACCGCGG -> TTAACCGCGGT
GTTAATGTAGT -> TTAATGTAGTA
GTTAGCACAGG -> TTAGCACAGGA
GTTAGGTATCT -> TTAGGTATCTA
GTTATATCTTG -> TTATATCTTGG
GTTATCGCGGC -> TTATCGCGGCT
GTTCAACAACT -> TTCAACAACTC
GTTCAGTGGGA -> TTCAGTGGGAG
GTTCCAGACTT -> TTCCAGACTTT
GTTCCCGGACT -> TTCCCGGACTA
GTTCCGCACAA -> TTCCGCACAAG
GTTCGCCCATA -> TTCGCCCATAT
GTTCGTGCAAA -> TTCGTGCAAAG
GTTCTAATACC -> TTCTAATACCG
GTTCTTGCTGC -> TTCTTGCTGCG
GTTGCACTACC -> TTGCACTACCA
GTTGCTATAGT -> TTGCTATAGTT
GTTGGATGCAC -> TTGGATGCACT
GTTGGCTTAGA -> TTGGCTTAGAC
GTTGGGATGAC -> TTGGGATGACG
GTTGGGCGCAA -> TTGGGCGCAAA
GTTGGGGACCC -> TTGGGGACCCC
GTTGGTCCACT -> TTGGTCCACTT
GTTGTACGTAT -> TTGTACGTATC
GTTGTATGTTC -> TTGTATGTTCA
GTTGTATTAAC -> TTGTATTAACA
GTTGTCTCGAG -> TTGTCTCGAGA
GTTTACTTAGC -> TTTACTTAGCC
GTTTCTATGGG -> TTTCTATGGGA
GTTTGCATAAC -> TTTGCATAACA
GTTTGTCCCCT -> TTTGTCCCCTT
GTTTTAGAAAG -> TTTTAGAAAGA
TAAAAGATGAC -> AAAAGATGACC
TAAAAGCAAGA -> AAAAGCAAGAT
TAAACACTACC -> AAACACTACCC
TAAACGGTACT -> AAACGGTACTT
TAAAGAACCTA -> AAAGAACCTAA
TAAAGGCCGTA -> AAAGGCCGTAG
TAAAGGTATTC -> AAAGGTATTCC
TAAAGTAGTTT -> AAAGTAGTTTG
TAAATCTGAGG -> AAATCTGAGGT
TAAATTAGGAG -> AAATTAGGAGA
TAACACCTTAA -> AACACCTTAAT
TAACACGGAAT -> AACACGGAATG
TAACCACTATT -> AACCACTATTA
TAACCCAATCT -> AACCCAATCTG
TAACCCGATGG -> AACCCGATGGC
TAACCGCGGTG -> AACCGCGGTGT
TAACCGTCGTT -> AACCGTCGTTG
TAACGACTTGG -> AACGACTTGGG
TAACGGAAGGG -> AACGGAAGGGC
TAACGGATCAC -> AACGGATCACA
TAACGTAACGG -> AACGTAACGGA
TAACGTTTTAG -> AACGTTTTAGA
TAAGAGAGTAA -> AAGAGAGTAAA
TAAGAGGATAA -> AAGAGGATAAA
TAAGGCACTGT -> AAGGCACTGTC
TAAGTCTCTCT -> AAGTCTCTCTG
TAATAAGAGAG -> AATAAGAGAGT
TAATACCGTCC -> AATACCGTCCG
TAATCCAGTGA -> AATCCAGTGAG
TAATGTAGTAG -> AATGTAGTAGG
TAATTCAATTA -> AATTCAATTAC
TAATTCACTGT -> AATTCACTGTT
TAATTTAAAAG -> AATTTAAAAGC
TAATTTCATTC -> AATTTCATTCT
TACACAAAGCT -> ACACAAAGCTC
TACACATCACG -> ACACATCACGC
TACACGTCAGT -> ACACGTCAGTT
TACATATTGCC -> ACATATTGCCT
TACCAAATGCG -> ACCAAATGCGC
TACCAATACTC -> ACCAATACTCT
TACCACTAACG -> ACCACTAACGT
TACCATTGCAA -> ACCATTGCAAC
TACCCACAACA -> ACCCACAACAA
TACCCAGTCTT -> ACCCAGTCTTG
TACCCGTGCTC -> ACCCGTGCTCA
TACCGAGGCCC -> ACCGAGGCCCC
TACCGTCCGCG -> ACCGTCCGCGA
TACCTCACTTG -> ACCTCACTTGA
TACGAAAAGTA -> ACGAAAAGTAG
TACGAGAAACT -> ACGAGAAACTC
TACGCCCACGG -> ACGCCCACGGG
TACGCCTGGAG -> ACGCCTGGAGA
TACGGGGTCAC -> ACGGGGTCACC
TACGGTGGTAG -> ACGGTGGTAGT
TACGTATCTCC -> ACGTATCTCCT
TACGTGTTCTA -> ACGTGTTCTAA
TACTCTGAAGT -> ACTCTGAAGTC
TACTGCGCGTC -> ACTGCGCGTCC
TACTTAAATTA -> ACTTAAATTAG
TACTTAAGTCT -> ACTTAAGTCTC
TACTTAGCCCG -> ACTTAGCCCGT
TACTTCAAGTG -> ACTTCAAGTGA
TACTTGACTAG -> ACTTGACTAGC
TAGAAAGAATG -> AGAAAGAATGT
TAGAAAGCCCC -> AGAAAGCCCCC
TAGAATTGTAT -> AGAATTGTATA
TAGACCCCTGG -> AGACCCCTGGT
TAGCAATCAGT -> AGCAATCAGTT
TAGCACAGGAG -> AGCACAGGAGA
TAGCATACGTG -> AGCATACGTGT
TAGCCCGTCAC -> AGCCCGTCACA
TAGCGCCATGT -> AGCGCCATGTT
TAGCGCCGATT -> AGCGCCGATTG
TAGCGGCTTTC -> AGCGGCTTTCG
TAGCTCAACCA -> AGCTCAACCAA
TAGCTGCCTGG -> AGCTGCCTGGA
TAGCTTGGGCC -> AGCTTGGGCCA
TAGGAAACCAG -> AGGAAACCAGA
TAGGAAATGCC -> AGGAAATGCCC
TAGGAGACCAA -> AGGAGACCAAC
TAGGCCTGAAC -> AGGCCTGAACA
TAGGCTGGTGC -> AGGCTGGTGCG
TAGGTATCTAC -> AGGTATCTACC
TAGGTCAGGTG -> AGGTCAGGTGT
TAGGTTGGGCG -> AGGTTGGGCGC
TAGTAAAGGTA -> AGTAAAGGTAT
TAGTAGGCTGG -> AGTAGGCTGGT
TAGTCCGGCGA -> AGTCCGGCGAC
TAGTCGAACTT -> AGTCGAACTTT
TAGTGGATCCG -> AGTGGATCCGA
TAGTGTCCAGA -> AGTGTCCAGAA
TAGTGTGGATG -> AGTGTGGATGA
TAGTTGGATGC -> AGTTGGATGCA
TAGTTTGCATA -> AGTTTGCATAA
TATAACCACTA -> ATAACCACTAT
TATAATAAGAG -> ATAATAAGAGA
TATAATCCAGT -> ATAATCCAGTG
TATAGTTGGAT -> ATAGTTGGATG
TATATCTTGGA -> ATATCTTGGAC
TATCCATTCAT -> ATCCATTCATC
TATCGCGGCTC -> ATCGCGGCTCC
TATCGGGTAAG -> ATCGGGTAAGA
TATCGTACGCC -> ATCGTACGCCC
TATCTACCAAA -> ATCTACCAAAT
TATCTACCAAT -> ATCTACCAATA
TATCTCACATA -> ATCTCACATAT
TATCTCCTTGG -> ATCTCCTTGGA
TATCTTGATTG -> ATCTTGATTGG
TATCTTGGACT -> ATCTTGGACTT
TATGAGCGTAT -> ATGAGCGTATC
TATGATCGATG -> ATGATCGATGG
TATGGCCAAAC -> ATGGCCAAACC
TATGGGACCTA -> ATGGGACCTAG
TATGTAACGGA -> ATGTAACGGAT
TATGTACTTGA -> ATGTACTTGAC
TATGTCCGCGC -> ATGTCCGCGCG
TATGTTCAGTG -> ATGTTCAGTGG
TATTACACGTC -> ATTACACGTCA
TATTCCTCATA -> ATTCCTCATAC
TATTCGCGCTT -> ATTCGCGCTTA
TATTCTCACGA -> ATTCTCACGAG
TATTCTGTACT -> ATTCTGTACTT
TATTGCCTGTA -> ATTGCCTGTAT
TATTTCGTAGA -> ATTTCGTAGAA
TCAACAACTCT -> CAACAACTCTC
TCAACCAAGCA -> CAACCAAGCAT
TCAAGAAGTTT -> CAAGAAGTTTA
TCAAGCCCGGT -> CAAGCCCGGTG
TCAAGTGACGC -> CAAGTGACGCC
TCAATTACGGG -> CAATTACGGGG
TCACACTGGTA -> CACACTGGTAG
TCACAGTCCGA -> CACAGTCCGAC
TCACATATCGG -> CACATATCGGG
TCACCAGGTTA -> CACCAGGTTAA
TCACCCTACCG -> CACCCTACCGA
TCACCGTCGTA -> CACCGTCGTAA
TCACGAGGGCC -> CACGAGGGCCT
TCACGCAAGAT -> CACGCAAGATA
TCACTGTTATC -> CACTGTTATCG
TCACTTCCTCG -> CACTTCCTCGA
TCACTTGAGTG -> CACTTGAGTGA
TCAGCTGTTGT -> CAGCTGTTGTA
TCAGCTTTCCA -> CAGCTTTCCAC
TCAGGTGTCCC -> CAGGTGTCCCC
TCAGTCGGAGA -> CAGTCGGAGAT
TCAGTGGGAGG -> CAGTGGGAGGC
TCAGTTGGCTT -> CAGTTGGCTTA
TCAGTTGGTCC -> CAGTTGGTCCA
TCATACACATC -> CATACACATCA
TCATACGAGAA -> CATACGAGAAA
TCATCCCTCAG -> CATCCCTCAGC
TCATCGGCCCA -> CATCGGCCCAG
TCATGTGCACT -> CATGTGCACTC
TCATTCTATGT -> CATTCTATGTC
TCCAAACTATG -> CCAAACTATGG
TCCACAACTTC -> CCACAACTTCC
TCCACTTCACT -> CCACTTCACTT
TCCAGAAAGCC -> CCAGAAAGCCG
TCCAGACTTTT -> CCAGACTTTTA
TCCAGCATTGA -> CCAGCATTGAC
TCCAGTGAGTT -> CCAGTGAGTTG
TCCATTCATCC -> CCATTCATCCC
TCCATTGGTAT -> CCATTGGTATC
TCCCAGTTCTT -> CCCAGTTCTTG
TCCCCGTTCAA -> CCCCGTTCAAC
TCCCCTTATGT -> CCCCTTATGTA
TCCCGGACTAG -> CCCGGACTAGC
TCCCGGGAGCG -> CCCGGGAGCGA
TCCCTCAGCTG -> CCCTCAGCTGT
TCCCTCCGATG -> CCCTCCGATGT
TCCCTGTCGCG -> CCCTGTCGCGA
TCCCTTCCTAG -> CCCTTCCTAGG
TCCGAATCCCG -> CCGAATCCCGG
TCCGACAATTA -> CCGACAATTAT
TCCGAGCTGAG -> CCGAGCTGAGT
TCCGATGTGGC -> CCGATGTGGCG
TCCGCACAAGT -> CCGCACAAGTG
TCCGCGATCTT -> CCGCGATCTTA
TCCGCGCGCCT -> CCGCGCGCCTT
TCCGCTAACCG -> CCGCTAACCGT
TCCGCTTTCGG -> CCGCTTTCGGG
TCCGGCGACGG -> CCGGCGACGGC
TCCGGGAAGCC -> CCGGGAAGCCG
TCCGGTTCGTG -> CCGGTTCGTGC
TCCTACATATT -> CCTACATATTG
TCCTAGGCCTG -> CCTAGGCCTGA
TCCTCATACGA -> CCTCATACGAG
TCCTCGAAAGA -> CCTCGAAAGAC
TCCTGTGCCGA -> CCTGTGCCGAG
TCCTTGGAGTT -> CCTTGGAGTTG
TCCTTTCATAC -> CCTTTCATACA
TCCTTTGCCCT -> CCTTTGCCCTA
TCGAAAGACGA -> CGAAAGACGAT
TCGAACTTTGG -> CGAACTTTGGC
TCGAATACCAC -> CGAATACCACT
TCGAGATCGAA -> CGAGATCGAAT
TCGAGCTCATC -> CGAGCTCATCG
TCGATAACGTA -> CGATAACGTAA
TCGATAGCTGC -> CGATAGCTGCC
TCGATGGGTGT -> CGATGGGTGTT
TCGCCCATATT -> CGCCCATATTT
TCGCGATGGAA -> CGCGATGGAAA
TCGCGCTTACC -> CGCGCTTACCC
TCGCGGCTCCT -> CGCGGCTCCTT
TCGGAAGGCGG -> CGGAAGGCGGT
TCGGAGATCCG -> CGGAGATCCGC
TCGGCCACTGA -> CGGCCACTGAC
TCGGCCCAGTC -> CGGCCCAGTCA
TCGGCTATAAC -> CGGCTATAACC
TCGGGAATTTT -> CGGGAATTTTC
TCGGGTAAGAG -> CGGGTAAGAGG
TCGGTACACAA -> CGGTACACAAA
TCGGTACTGCG -> CGGTACTGCGC
TCGGTGAGATA -> CGGTGAGATAG
TCGGTTCCGCA -> CGGTTCCGCAC
TCGGTTCGCCC -> CGGTTCGCCCA
TCGTAACCCAA -> CGTAACCCAAT
TCGTACGCCCA -> CGTACGCCCAC
TCGTAGAATTG -> CGTAGAATTGT
TCGTATGATCG -> CGTATGATCGA
TCGTGCAAAGT -> CGTGCAAAGTT
TCGTTGTACGT -> CGTTGTACGTA
TCTAATACCGT -> CTAATACCGTC
TCTACCAAATG -> CTACCAAATGC
TCTACCAATAC -> CTACCAATACT
TCTACCCGTGC -> CTACCCGTGCT
TCTAGTGGATC -> CTAGTGGATCC
TCTATGGGACC -> CTATGGGACCT
TCTATGTCCGC -> CTATGTCCGCG
TCTCACATATC -> CTCACATATCG
TCTCACGAGGG -> CTCACGAGGGC
TCTCCAAACTA -> CTCCAAACTAT
TCTCCCAGTTC -> CTCCCAGTTCT
TCTCCTTGGAG -> CTCCTTGGAGT
TCTCCTTTCAT -> CTCCTTTCATA
TCTCGAGATCG -> CTCGAGATCGA
TCTCTACCCGT -> CTCTACCCGTG
TCTCTCCTTTC -> CTCTCCTTTCA
TCTCTCTGCCG -> CTCTCTGCCGA
TCTCTGCCGAG -> CTCTGCCGAGT
TCTCTTTACGC -> CTCTTTACGCC
TCTGAAGGGCG -> CTGAAGGGCGT
TCTGAAGTCTC -> CTGAAGTCTCC
TCTGAGGTAGG -> CTGAGGTAGGA
TCTGCCGAGTG -> CTGCCGAGTGG
TCTGTACTTAA -> CTGTACTTAAG
TCTTACGAAAA -> CTTACGAAAAG
TCTTACGGTGG -> CTTACGGTGGT
TCTTGATTGGA -> CTTGATTGGAC
TCTTGCCATCG -> CTTGCCATCGG
TCTTGCTGCGA -> CTTGCTGCGAT
TCTTGGACTTC -> CTTGGACTTCA
TCTTTACGCCT -> CTTTACGCCTG
TGAACACACTG -> GAACACACTGC
TGAAGACAAAT -> GAAGACAAATA
TGAAGCGCAAC -> GAAGCGCAACG
TGAAGGGCGTC -> GAAGGGCGTCG
TGAAGTCTCCA -> GAAGTCTCCAA
TGAATCAAGCC -> GAATCAAGCCC
TGACCGTGCAA -> GACCGTGCAAG
TGACGCCCTGT -> GACGCCCTGTC
TGACGTGAGTG -> GACGTGAGTGA
TGACGTTAACA -> GACGTTAACAC
TGACGTTGTCT -> GACGTTGTCTC
TGACTAGCGCC -> GACTAGCGCCA
TGACTGCTCCT -> GACTGCTCCTG
TGACTTATGTA -> GACTTATGTAA
TGAGATAGCGC -> GAGATAGCGCC
TGAGCGTATCT -> GAGCGTATCTA
TGAGGGATCAT -> GAGGGATCATG
TGAGGTAGGAA -> GAGGTAGGAAA
TGAGTCACCCT -> GAGTCACCCTA
TGAGTGAAGCG -> GAGTGAAGCGC
TGAGTGAATCA -> GAGTGAATCAA
TGAGTTGGGGA -> GAGTTGGGGAC
TGATAGAAAGC -> GATAGAAAGCC
TGATCAAGAAG -> GATCAAGAAGT
TGATCCTACAT -> GATCCTACATA
TGATCGATGGG -> GATCGATGGGT
TGATTGGACTG -> GATTGGACTGG
TGCAAAGTTTC -> GCAAAGTTTCT
TGCAACATCTA -> GCAACATCTAG
TGCAAGCACGA -> GCAAGCACGAT
TGCACTACCAT -> GCACTACCATT
TGCACTCGGCC -> GCACTCGGCCA
TGCACTCGGTT -> GCACTCGGTTC
TGCACTCTCTT -> GCACTCTCTTT
TGCATAACACG -> GCATAACACGG
TGCCATCGGCT -> GCCATCGGCTA
TGCCCATTTAT -> GCCCATTTATC
TGCCCTAGCTC -> GCCCTAGCTCA
TGCCGAGCTGA -> GCCGAGCTGAC
TGCCGAGTGGC -> GCCGAGTGGCT
TGCCTGGAACC -> GCCTGGAACCG
TGCCTGTATCT -> GCCTGTATCTC
TGCGATGGAGT -> GCGATGGAGTT
TGCGCCATCCC -> GCGCCATCCCT
TGCGCGCTCGG -> GCGCGCTCGGT
TGCGCGTCCGG -> GCGCGTCCGGG
TGCGCTGGCTC -> GCGCTGGCTCC
TGCGGCTTTGC -> GCGGCTTTGCT
TGCGGTTGTAT -> GCGGTTGTATG
TGCTAATTCAC -> GCTAATTCACT
TGCTATAGTTG -> GCTATAGTTGG
TGCTCAGCTTT -> GCTCAGCTTTC
TGCTCCTGTGC -> GCTCCTGTGCC
TGCTGCGATGG -> GCTGCGATGGA
TGGAAATGATC -> GGAAATGATCA
TGGAACCGGTT -> GGAACCGGTTG
TGGACCAGTAT -> GGACCAGTATT
TGGACTGGGCC -> GGACTGGGCCA
TGGACTTCAGT -> GGACTTCAGTC
TGGAGACGAAG -> GGAGACGAAGT
TGGAGTTAGCA -> GGAGTTAGCAC
TGGAGTTGCTA -> GGAGTTGCTAT
TGGATCCGAAT -> GGATCCGAATC
TGGATGATAGA -> GGATGATAGAA
TGGATGCACTC -> GGATGCACTCG
TGGCAAACGAC -> GGCAAACGACA
TGGCAATGAAG -> GGCAATGAAGA
TGGCATACCTC -> GGCATACCTCA
TGGCCAAACCA -> GGCCAAACCAT
TGGCGCGTCCA -> GGCGCGTCCAG
TGGCGGGAATT -> GGCGGGAATTA
TGGCTCCGGTT -> GGCTCCGGTTC
TGGCTGCGGTT -> GGCTGCGGTTG
TGGCTTAGACC -> GGCTTAGACCC
TGGGACCTAGG -> GGGACCTAGGT
TGGGAGGCCCT -> GGGAGGCCCTA
TGGGATGACGT -> GGGATGACGTG
TGGGCCAATCG -> GGGCCAATCGG
TGGGCCACAAG -> GGGCCACAAGA
TGGGCGCAAAT -> GGGCGCAAATT
TGGGGACCCCG -> GGGGACCCCGA
TGGGGTCTCTC -> GGGGTCTCTCC
TGGGTGTTATA -> GGGTGTTATAT
TGGGTTAGGTA -> GGGTTAGGTAT
TGGTAGCTTGG -> GGTAGCTTGGG
TGGTAGTGTCC -> GGTAGTGTCCA
TGGTATCCATT -> GGTATCCATTC
TGGTCCACTTC -> GGTCCACTTCA
TGGTGCGCGCT -> GGTGCGCGCTC
TGGTTAACCCG -> GGTTAACCCGA
TGTAACGGATC -> GTAACGGATCA
TGTACGTATCT -> GTACGTATCTC
TGTACTTAAGT -> GTACTTAAGTC
TGTACTTGACT -> GTACTTGACTA
TGTAGTAGGCT -> GTAGTAGGCTG
TGTATAATCCA -> GTATAATCCAG
TGTATCTCACA -> GTATCTCACAT
TGTATCTTGAT -> GTATCTTGATT
TGTATGAGCGT -> GTATGAGCGTA
TGTATGTTCAG -> GTATGTTCAGT
TGTATTAACAG -> GTATTAACAGG
TGTCCAGAAAG -> GTCCAGAAAGC
TGTCCCCGTTC -> GTCCCCGTTCA
TGTCCCCTTAT -> GTCCCCTTATG
TGTCCCTTCCT -> GTCCCTTCCTA
TGTCCGCGCGC -> GTCCGCGCGCC
TGTCGAGCTCA -> GTCGAGCTCAT
TGTCGCGATGG -> GTCGCGATGGA
TGTCTCGAGAT -> GTCTCGAGATC
TGTGCACTCGG -> GTGCACTCGGT
TGTGCCGAGCT -> GTGCCGAGCTG
TGTGCGCCATC -> GTGCGCCATCC
TGTGGATGATA -> GTGGATGATAG
TGTGGCGGGAA -> GTGGCGGGAAT
TGTTATATCTT -> GTTATATCTTG
TGTTATCGCGG -> GTTATCGCGGC
TGTTCAGTGGG -> GTTCAGTGGGA
TGTTCCAGACT -> GTTCCAGACTT
TGTTCTAATAC -> GTTCTAATACC
TGTTGTATTAA -> GTTGTATTAAC
TGTTTGTCCCC -> GTTTGTCCCCT
TTAAAAGCAAG -> TAAAAGCAAGA
TTAAAGAACCT -> TAAAGAACCTA
TTAAATTAGGA -> TAAATTAGGAG
TTAACACCTTA -> TAACACCTTAA
TTAACCCGATG -> TAACCCGATGG
TTAACCGCGGT -> TAACCGCGGTG
TTAAGTCTCTC -> TAAGTCTCTCT
TTAATGTAGTA -> TAATGTAGTAG
TTAATTCAATT -> TAATTCAATTA
TTAATTTAAAA -> TAATTTAAAAG
TTACACGTCAG -> TACACGTCAGT
TTACCCACAAC -> TACCCACAACA
TTACGAAAAGT -> TACGAAAAGTA
TTACGCCTGGA -> TACGCCTGGAG
TTACGGGGTCA -> TACGGGGTCAC
TTACGGTGGTA -> TACGGTGGTAG
TTACTTAAATT -> TACTTAAATTA
TTACTTAGCCC -> TACTTAGCCCG
TTAGAAAGAAT -> TAGAAAGAATG
TTAGACCCCTG -> TAGACCCCTGG
TTAGCACAGGA -> TAGCACAGGAG
TTAGCCCGTCA -> TAGCCCGTCAC
TTAGGAGACCA -> TAGGAGACCAA
TTAGGTATCTA -> TAGGTATCTAC
TTAGTAAAGGT -> TAGTAAAGGTA
TTAGTCCGGCG -> TAGTCCGGCGA
TTATAATAAGA -> TATAATAAGAG
TTATATCTTGG -> TATATCTTGGA
TTATCGCGGCT -> TATCGCGGCTC
TTATCGTACGC -> TATCGTACGCC
TTATGTAACGG -> TATGTAACGGA
TTATGTACTTG -> TATGTACTTGA
TTCAACAACTC -> TCAACAACTCT
TTCAAGTGACG -> TCAAGTGACGC
TTCAATTACGG -> TCAATTACGGG
TTCACTGTTAT -> TCACTGTTATC
TTCACTTCCTC -> TCACTTCCTCG
TTCAGTCGGAG -> TCAGTCGGAGA
TTCAGTGGGAG -> TCAGTGGGAGG
TTCATACACAT -> TCATACACATC
TTCATCCCTCA -> TCATCCCTCAG
TTCATTCTATG -> TCATTCTATGT
TTCCACAACTT -> TCCACAACTTC
TTCCAGACTTT -> TCCAGACTTTT
TTCCCGGACTA -> TCCCGGACTAG
TTCCCTCCGAT -> TCCCTCCGATG
TTCCGCACAAG -> TCCGCACAAGT
TTCCGCTAACC -> TCCGCTAACCG
TTCCTAGGCCT -> TCCTAGGCCTG
TTCCTCATACG -> TCCTCATACGA
TTCCTCGAAAG -> TCCTCGAAAGA
TTCGCCCATAT -> TCGCCCATATT
TTCGCGCTTAC -> TCGCGCTTACC
TTCGGGAATTT -> TCGGGAATTTT
TTCGGTTCGCC -> TCGGTTCGCCC
TTCGTAGAATT -> TCGTAGAATTG
TTCGTGCAAAG -> TCGTGCAAAGT
TTCTAATACCG -> TCTAATACCGT
TTCTATGGGAC -> TCTATGGGACC
TTCTATGTCCG -> TCTATGTCCGC
TTCTCACGAGG -> TCTCACGAGGG
TTCTGTACTTA -> TCTGTACTTAA
TTCTTGCTGCG -> TCTTGCTGCGA
TTGACGTTAAC -> TGACGTTAACA
TTGACTAGCGC -> TGACTAGCGCC
TTGAGTGAATC -> TGAGTGAATCA
TTGATCCTACA -> TGATCCTACAT
TTGATTGGACT -> TGATTGGACTG
TTGCAACATCT -> TGCAACATCTA
TTGCACTACCA -> TGCACTACCAT
TTGCATAACAC -> TGCATAACACG
TTGCCATCGGC -> TGCCATCGGCT
TTGCCCTAGCT -> TGCCCTAGCTC
TTGCCTGTATC -> TGCCTGTATCT
TTGCTAATTCA -> TGCTAATTCAC
TTGCTATAGTT -> TGCTATAGTTG
TTGCTGCGATG -> TGCTGCGATGG
TTGGACTGGGC -> TGGACTGGGCC
TTGGACTTCAG -> TGGACTTCAGT
TTGGAGTTGCT -> TGGAGTTGCTA
TTGGATGCACT -> TGGATGCACTC
TTGGCAAACGA -> TGGCAAACGAC
TTGGCATACCT -> TGGCATACCTC
TTGGCTTAGAC -> TGGCTTAGACC
TTGGGATGACG -> TGGGATGACGT
TTGGGCCACAA -> TGGGCCACAAG
TTGGGCGCAAA -> TGGGCGCAAAT
TTGGGGACCCC -> TGGGGACCCCG
TTGGGTTAGGT -> TGGGTTAGGTA
TTGGTATCCAT -> TGGTATCCATT
TTGGTCCACTT -> TGGTCCACTTC
TTGTACGTATC -> TGTACGTATCT
TTGTATAATCC -> TGTATAATCCA
TTGTATCTTGA -> TGTATCTTGAT
TTGTATGTTCA -> TGTATGTTCAG
TTGTATTAACA -> TGTATTAACAG
TTGTCCCCTTA -> TGTCCCCTTAT
TTGTCTCGAGA -> TGTCTCGAGAT
TTTAAAAGCAA -> TTAAAAGCAAG
TTTACGCCTGG -> TTACGCCTGGA
TTTACTTAGCC -> TTACTTAGCCC
TTTAGAAAGAA -> TTAGAAAGAAT
TTTAGTCCGGC -> TTAGTCCGGCG
TTTATCGTACG -> TTATCGTACGC
TTTCATACACA -> TTCATACACAT
TTTCATTCTAT -> TTCATTCTATG
TTTCCACAACT -> TTCCACAACTT
TTTCCCTCCGA -> TTCCCTCCGAT
TTTCGGGAATT -> TTCGGGAATTT
TTTCGGTTCGC -> TTCGGTTCGCC
TTTCGTAGAAT -> TTCGTAGAATT
TTTCTATGGGA -> TTCTATGGGAC
TTTGATCCTAC -> TTGATCCTACA
TTTGCATAACA -> TTGCATAACAC
TTTGCCCTAGC -> TTGCCCTAGCT
TTTGCTAATTC -> TTGCTAATTCA
TTTGGCAAACG -> TTGGCAAACGA
TTTGTCCCCTT -> TTGTCCCCTTA
TTTTAGAAAGA -> TTTAGAAAGAA
TTTTAGTCCGG -> TTTAGTCCGGC
TTTTCCCTCCG -> TTTCCCTCCGA